ian a	三分天下 千軍萬馬驚天下 天煞 獨霸天下 至尊功：開山劈石：上天下地：排山倒海：千軍萬馬：君臨天下 赤煞掌：鷹臨天下 道：傾拳天下 驚天殺
an ian a	道：傾拳天下
ing an ian a	道：傾拳天下
ang an	七傷拳 不滅鳳凰斷 光環 冰寒掌霹靂：六月飛霜玄 密宗金剛拳 幻影破陽拳 拳儀江山 海量汪涵 火龍獄雙轉 狂狼斬 聖王訣：外王六藝——傲書道：指點江山 虎豹雙拳 西洋拳 金剛鑽 金剛鑽 電光斬
i ang an	七傷拳 拳儀江山 西洋拳
an i ang an	拳儀江山
ian i	一瀉千里 五嶽毀天地 十殺天地 天地 天地玄掌：氣遊天地 天外逍遙篇：氣遊天地 天擊 天煞怒罵人天理 妖亂天地 拒人千里 拳為天地 斷脈劍氣 焦土千里 狂龍亂舞天地 白馬獻蹄 盤古五極：天極 虎千霹 血淹地 轟天擊 轟天殛 雷動天地 電殛 飛馬獻蹄 鷹鷹斂翼 龍跨千里
ei ian i	五嶽毀天地 拳為天地
an ei ian i	拳為天地
eng u	二龍爭珠 二龍爭珠 二龍爭珠 二龍爭珠 啄目爭珠 捨身成佛 殺心雷：殺心成佛 縱橫著 萬家生佛 雲龍風虎 雲龍風虎 餓龍爭珠 餓龍爭珠
ong eng u	二龍爭珠 二龍爭珠 二龍爭珠 二龍爭珠 縱橫著 雲龍風虎 雲龍風虎 餓龍爭珠 餓龍爭珠
vn ong eng u	雲龍風虎 雲龍風虎
v u	守若巨木 鴻漸於陸 鴻漸於陸 鴻漸於陸
o v u	守若巨木
ou o v u	守若巨木
ang ao	五路陽爪 兩儀八卦掌：綿里藏刀 怒湧狂潮 斷梁道 斷梁道 火裡藏刀 烈陽刀 無間道：天上道 逆天無我：逆水狂濤
ong ang ao	怒湧狂潮
u ong ang ao	怒湧狂潮
o II	修羅指 千夫所指 天魔蝕 撥勢 殘鷹落日 無相破元氣：開天破日 爆破式 狂龍破日 狂龍破日 破空元手：破元手：破雷殛震空元手：空元破日 神鷹破日 群鷹奪食 蠍天破石 逆天破：天王破日 雙陽劍：驚虹破日 鷹王破日 鷹王破日
ong o II	狂龍破日 狂龍破日 雙陽劍：驚虹破日
ang ong o II	狂龍破日 狂龍破日
u ang	劍無雙 功德無量 千手無量 喜無量 四方如來氣無量 四梵無量心：慈無量 大海無量 如意七轉：運轉無常 悲無量 慈無量 搜索​​枯腸 搜索枯腸 摩訶無量 殛虛空：拳殛無量 涅槃七劫拳：劫無相 狂濤無量 狂龍無量 舍無量 萬壽無疆 進馬出掌 達摩禪劍：一菩渡江 鐵血無雙 降千佛掌 陰風毒掌 驚濤無量
i u ang	喜無量 四方如來氣無量 殛虛空：拳殛無量
an i u ang	殛虛空：拳殛無量
ong ing	千雷轟頂 天雷轟頂 雙雷轟頂 雷雷：五雷轟頂
ei ong ing	千雷轟頂 天雷轟頂 雙雷轟頂 雷雷：五雷轟頂
ang ei ong ing	雙雷轟頂
ou ang	天罡拳：鬼頭降 推酒掌 聖火神功：爆肘撞 芙蓉腿：蓉桂柳芳 赤蓋四陽功：首陽
ei ou ang	天罡拳：鬼頭降 推酒掌 芙蓉腿：蓉桂柳芳
： ei ou ang	天罡拳：鬼頭降
ve i	生血祭
eng ve i	生血祭
v o	地獄火 祝融浴火
i v o	地獄火
o ou	修羅咒 側身右字過肘 冥火球 天魔秘大法：：魔眸 幽冥鬼爪：白骨鎖喉 煉獄真火球 笑羅漢醉羅漢：醉拳鎖手 絲前搏後
ou o ou	修羅咒
ei ie	輪迴劫
en ei ie	輪迴劫
： an	大海暴崩：淵
eng ： an	大海暴崩：淵
ao eng ： an	大海暴崩：淵
ai ao	天霸拳：怒海嘯 暴海嘯 毒尾龍形：金龍擺爪 血在燒 鐵拐李系葫蘆腰間離拐摔倒
ao ai ao	暴海嘯
ao ang	回潮浪 火傘高張 神鳥四絕：鳳凰朝王 絞腸 詠春標掌 金定橋相 雙鳳朝凰 顛陰倒陽 鳳鳴朝陽
ei ao ang	回潮浪
ao ei	一星拋捶 三界雷霆二霸：九霄雷 二星桃拋捶 沖天豹豹捶 潮水 爆肺 虎眼豹捶 還魂飽鶴形：雙動豹錘 霹靂暴雷
ian ai	天籟 百穴遍海 神行八法：精衛填海 青天開
ve ian ai	百穴遍海
ai ve ian ai	百穴遍海
u ai ao	天霸拳：怒海嘯
： u ai ao	天霸拳：怒海嘯
ao eng	九闕三焦生 九霄真經：颷風 旋轉暴風 驚濤峰
ing ao eng	驚濤峰
eng eng	千火崩崩
o eng eng	千火崩崩
ian o eng eng	千火崩崩
v ai	雨蓋
ong en	怒龍身 白骨指：血染紅塵 紅塵 蕭蕭殺紅塵
ang eng	乾坤轉業雙明：因果相承 勾魂鬼爪：血肉長城 怒毀長城 暴雨狂風 蒼冷 血肉長城 陰陽無常判官指：一指陰陽恆
ve ian	日月變 碧雪劍
II ve ian	日月變
i ie	天旋地劫 寂滅 火網提鱉 誅天訣：天誅地滅 雷震劈邪
o en	怒碎風火輪 惟獨我尊 滅佛修黑雷拳：暴雷拳裂裂金身：屠羅無極修羅震 魔音：魔刃
u o en	惟獨我尊
ei u o en	惟獨我尊
ou ing	睡拳：夢遊行 豹打流星 飛影流星
eng ou ing	睡拳：夢遊行
： eng ou ing	睡拳：夢遊行
ao ing	伸腰頂 美人照鏡 霜霜河倒影配合步法：霜履薄冰
en ao ing	伸腰頂 美人照鏡
en ang	九陽五絕：霹靂神掌 易天乾坤掌 枕撞 落魂樁 達摩三絕：達摩神掌 離魂掌
o ian	四絕白骨爪：抽屍剝繭 真火托天 連環火箭 醉臥眠 龍破天
ei o ian	醉臥眠
ei en	天飛輪 擺鶴嘴沉 翻睡滾 蒼蒼茫茫滅碎坤 蠍尾追魂 追恨 追神 追魂 雷震 驚雷震 鬼手追魂 鷹嘴追魂
an ei en	翻睡滾
ou an	何仙姑睡睡象象床左右揉反 醉拳：敬酒拳 電光首斬 風捲樓殘 騎虎搜山
ing ou an	醉拳：敬酒拳
： ing ou an	醉拳：敬酒拳
ou ou	唐屍三百手：屍走尋魂颼手 屍走肉 曹國師仙人敬酒鎖喉扣 杯扣手 裂分九州 鎖喉扣 雷動山河震九州
ei ou ou	杯扣手
o ou ou	曹國師仙人敬酒鎖喉扣 鎖喉扣
ei u	以有為無 何仙姑彈腰獻酒醉盪步配合步法：醉步 凌波微步 半點空明半點柔之觀音大士九生皆醉我獨醒指如山乾坤定之如來佛祖千足法：醉步 煉石碎骨 破埕指配合步法：醉步 追魂鬼手配合步法：魅影鬼步 韓蕭響亮便蟠桃獻配合聲步法：醉步
： ei u	何仙姑彈腰獻酒醉盪步配合步法：醉步 半點空明半點柔之觀音大士九生皆醉我獨醒指如山乾坤定之如來佛祖千足法：醉步 破埕指配合步法：醉步 韓蕭響亮便蟠桃獻配合聲步法：醉步
a ： ei u	何仙姑彈腰獻酒醉盪步配合步法：醉步 半點空明半點柔之觀音大士九生皆醉我獨醒指如山乾坤定之如來佛祖千足法：醉步 破埕指配合步法：醉步 韓蕭響亮便蟠桃獻配合聲步法：醉步
en a	佛祖問法 千毒掌：風起雲湧毒鎖千峰配合毒縷：千毒絕心經配合身法：一輕煙身法 幽幽冥影魄身法配合身法：鬼魂法 狼殺拳：瞬殺 萬劫不復墮輪迴配合法：魔身法 追魂殺 還魂法 閻羅八殺爪：招魂殺
： en a	狼殺拳：瞬殺
an ： en a	狼殺拳：瞬殺
a ao	帶馬槽 直擊轟霸剿 虎頭鍘刀 鐵血狂殺道 陽世五絕掌：陽關大道
ong a ao	直擊轟霸剿
i ong a ao	直擊轟霸剿
ao II	佛光耀世 圍剿式 招式 本末倒置 焰龍抱日 焰龍抱日 絞噬 花間遊：醉入花叢人笑痴
ai ie	戰龍在野 戰龍在野 戰龍在野 戰龍在野 百裂 雷神疾旋金剛：內解外解 龍戰在野
v ve	傷心欲絕 浴血
I ian	天魔撕天 撕天 殺地撕天 無柱撕天 紫旋撕天 紫焰 血陽撕天
ao ong	萬佛朝宗 萬佛朝宗 萬佛朝宗 龍霸拳：現霹暴龍
i ao ong	龍霸拳：現霹暴龍
ian i ao ong	龍霸拳：現霹暴龍
u ong en	怒龍身
ou ian	威震九天 杞人憂天 狂狼吼天 降龍十八腿：龍在九天 降龍十八腿：龍在九天 雷動九天 雷動九天 雷動九天 雷行九天 龍在九天 龍在九天 龍在九天 龍在九天 龍在九天
en ou ian	威震九天 杞人憂天
ei en ou ian	威震九天
ong eng	大慈咒圈：憐我眾生 怒海縱橫 普渡眾生 普渡眾生 百毒縱橫 銅砲連環銅腳：銅馬縱橫 鐵蹄縱橫 龍影縱橫 龍影縱橫 龍影縱橫 龍影縱橫
ing ong eng	龍影縱橫 龍影縱橫 龍影縱橫 龍影縱橫
ong ing ong eng	龍影縱橫 龍影縱橫 龍影縱橫 龍影縱橫
ai ong eng	怒海縱橫
u ai ong eng	怒海縱橫
o u	天殘破木 天魔怒 披霜凌撥露 爭明奪目 窮途末路 金剛魔伏 鷹嘴奪珠 龍九天配合步法：龍渦步
ong o u	龍九天配合步法：龍渦步
： ong o u	龍九天配合步法：龍渦步
u ian	九轉珠連 佛光初現 佛法無邊 佛法無邊 冰火五重天：火龍初現 冰火五重天：火龍初現 劫如電 地煞拳：裹足不前 天佛掌：佛光初現 如來神掌：佛光初現 火海無邊 火海無邊 無限 白虎天 穹蒼無邊 苦海無邊 虎擺鶴雙形拳：龍虎出現 虎澗 誅天 豹逐電 速限 達摩神劍：佛光初現 達摩神掌：佛法無邊 采虹補天 鋤奸 雙蓮吐艷 雷電神腿首六式：電光初現 雷電神腿：電光初現 雷電神首腿：電光初現 風火無邊 風霜霜撲面
u u ian	地煞拳：裹足不前 虎擺鶴雙形拳：龍虎出現
o u u ian	地煞拳：裹足不前
I ong	無地自容
i I ong	無地自容
u i I ong	無地自容
a ian a	獨霸天下
u a ian a	獨霸天下
en ong	左右神龍 左右神龍 左右神龍 左右神龍 彈指神通：貫神通 彈神通 旋神通 日月神鑑：烈陽神功 暮鼓晨鐘 烈火劫：火海無涯暴火劫：火輪煉獄天火劫：萬里焚空 烈風旋渦問雷式：震空 無相神功 絕地困龍 遙恆派神功
i en ong	烈火劫：火海無涯暴火劫：火輪煉獄天火劫：萬里焚空 絕地困龍
ve i en ong	絕地困龍
ian ou	煞殺千秋 詠春小念頭
a ian ou	煞殺千秋
a a ian ou	煞殺千秋
en ian i	天煞怒罵人天理 拒人千里
a en ian i	天煞怒罵人天理
eng vn	六道萬行御風雲 動風雲 地缺掌法：蛟騰雲 完美神技：紛擾擾斷風雲 風雲
u ei ong ing	雷雷：五雷轟頂
ai ian	千錘百煉 奔旱雷拳開天 怒海天 盤古開天 見龍在田 見龍在田 見龍在田 見龍在田 見龍在田 見龍在田 見龍在田 見龍在田 見龍在田 金甲神功：山海篇 飛龍在天 飛龍在天 飛龍在天 飛龍在天 飛龍在天 飛龍在天 龍在天
an ai ian	奔旱雷拳開天 金甲神功：山海篇
ei an ai ian	奔旱雷拳開天
ang ei	五怒狂雷 帝天狂雷 帝天狂雷 暴雨狂雷 暴雨狂雷 標雙飛 百變烈陽腿 盤龍雙飛 神奇金剛腿 蝶影雙飛 蝶舞翩翩戲香蕊 蟠龍雙飛 蟠龍雙飛 蟠龍雙飛 金豹雙捶 鐵家腿法：暴雨狂雷
v ang ei	暴雨狂雷 暴雨狂雷 鐵家腿法：暴雨狂雷
ao v ang ei	暴雨狂雷 暴雨狂雷 鐵家腿法：暴雨狂雷
an ie	七傷拳：肝裂 寒山梅花三疊 緣起緣滅 鬼劫仙功：纏結
： an ie	七傷拳：肝裂 鬼劫仙功：纏結
an ： an ie	七傷拳：肝裂
en ao	兇豹殺拳：懶豹伸腰 妖魂霄 少林金剛腿：金伸腰 懶佛伸腰 歸手沉腰 第八重鬼哭鬼哭神號 第十三重鬼哭鬼神號 震腦 鬼門道 鬼門道 龍伸腰
i i	三箭元及第一 不倒三擊：撼山抽屜地 以逸 倒天逆地 切肉離皮 地極 天穹五道：冬日熙熙 天雷霹靂：天雷霹靂 寒冰霹靂 意極 晴天霹靂 殛脾 烈陽霹靂 烏柔棄翼 神雷一擊 裂魔霹靂手：群辟易 逆地 陰陽兩極氣 雪糖霹靂 雷霆一擊 雷霆破霹靂 震雷霹靂 霹靂 霹靂神掌：九陽小霹靂 頭霹靂 驚雷惡電惡電三行：驚雷三轟：雷電霹靂 鬼神辟易
ei in	五世回二脈印元：五世輪迴印 五世輪迴印 空歸印 萬毒歸心 錐心
o an	兩極三問：問風式：渦旋 刻骨破腕 天羅漢 心錐：炎火鑽 斷筋破骨大劈手：怒打羅漢 破膽 黑煞魔功：天雷破山 龍騰火淵 龍騰火淵
ong ve	五嶽：撼東岳 五行轟岳 心惡痛絕 逍遙掌：雙仙拱月 鷹鷹雄躍
an ong ve	五嶽：撼東岳
： an ong ve	五嶽：撼東岳
i ve	九陰遺訣 天滅地絕 崩西嶽 破地訣
eng i ve	崩西嶽
an ve	五絕殺神手：折骨斷絕 人寰慘絕 化金元訣 十陽之氣穿越 坤崙斷岳 掃南嶽 殘虐 紫電斷岳 蛇形刁手：靈蛇探穴 雙芒趕月 雪龍翻月 雪龍翻月 靈蛇七絕：毒探穴 飛星趕月
ao an ve	掃南嶽
ei ve	轉北岳
an ei ve	轉北岳
ve ei ian i	五嶽毀天地
II in	惡獅擒 智印 王獅神獅拳：雄獅勁 魔佛降世心 黃石金
ong II in	王獅神獅拳：雄獅勁
： ong II in	王獅神獅拳：雄獅勁
u II	力在布施 怒獅 惡蝠勢 撲撲噬 狂狼逐日 狂獅逐日 瘋狼屠獅 貝葉掌：法華渡世
II u	七十二路空明拳：左右互搏之術 仙人指路 勾魂蝕骨 天魔蝕骨 惡獅撲 絡脈十五 虛實著
e II u	惡獅撲
II II	勢勢 吸天蝕日 天殘蝕日 狂獅噬 狼噬日 白華蝕日 盤龍蝕日 鷹王噬日
ang II II	狂獅噬 狼噬日 鷹王噬日
a ing	五嶽拳：泰山壓頂 凌雲壓頂 昊天罡氣：十全霸境 飛龍壓頂 飛龍壓頂
an a ing	五嶽拳：泰山壓頂 昊天罡氣：十全霸境
ai an a ing	五嶽拳：泰山壓頂
a an	佛問迦藍 佛問迦藍 利涉大川 利涉大川 怒劈華山 橫掃千軍象拔拳 虎虎下山 西嶽華山 金剛下凡 開山掌：怒劈華山 雪花仙指：天仙下凡 龍涉大川
i a an	怒劈華山 開山掌：怒劈華山
u i a an	怒劈華山 開山掌：怒劈華山
eng an	北岳恆山 南嶽衡山 左右逢源 雷雷旋風轉 風湧恆山
ong eng an	風湧恆山
eng ong eng an	風湧恆山
ve a	穹蒼血甲 衡山躍馬 電光攫霸
an ve a	衡山躍馬
eng an ve a	衡山躍馬
an vn	劈空掌法：裂空斷雲 大風雲手：破風斷雲 嵩山穿雲 幻雲 日焰卷雲 火箭穿雲 聖心訣：萬仞穿雲 聖心訣：萬刃穿雲 金劍穿雲 鐵橋八形：龍翔翻雲 雷霆萬鈞 雷霆萬鈞 風捲殘雲 風捲殘雲 風捲殘雲 風捲殘雲 風捲雲 龍捲殘雲
an an vn	嵩山穿雲 風捲殘雲 風捲殘雲 風捲殘雲 風捲殘雲 龍捲殘雲
ong an an vn	嵩山穿雲 龍捲殘雲
ei eng	倍增 回夢 地火圍城 追夢 追風 通反勝與紅頂白敗為勝
ai ei eng	通反勝與紅頂白敗為勝
ai ai ei eng	通反勝與紅頂白敗為勝
i an	共工移川 地關 天地斬 婆羅魔經：絕息關 愚公移山 星河氣旋 殺神四式：天萬愁地慘 氣關 獨臂單 逆風圍七拳 雷神疾：雷神疾閃 龍捲氣旋
ei i an	逆風圍七拳
eng ei i an	逆風圍七拳
an ang	三陽 光芒萬丈 哭斷腸 地霸氣訣之陰陽玄剛 大小通吃三方 天羅天萬網 沉橋橋串掌 百步穿揚 禪杖 禪槍 紫電千電羅萬網 絕木幹罡 蛟龍翻江 蟠龍翻江 蟠龍翻江
II an ang	大小通吃三方
ong II an ang	大小通吃三方
II en	人八雙天至尊 先發製人 廢寢食若失恨 破虛空：撲前九式標誌真 萬惡世尊 食若失恨
ian II en	人八雙天至尊
ang ian II en	人八雙天至尊
u ao	並右步標 九死白骨爪 九陰白骨爪 九陽普照 佛光普照 佛光普照 倒如來降魔伏妖 剔骨道 剔骨道 暴雷誅妖 梵爐道 梵爐道 殺無道 烈陽普照 烈陽神掌：烈陽普照 無道拳：地無道 狂無道 金鑼普照 鐵線拳：三度珠橋 陰陽三式：陰陽毒爪 霧渺 骨橋 魔：邪無道
u u ao	鐵線拳：三度珠橋
an u u ao	鐵線拳：三度珠橋
ao an	凶獸暴拳 十萬刀山 地火燎原 地火燎原 獨臂橋單 絞旋 絞轉 老僧挑擔 聖火燎原 離火燎原 鬼火燎原 鳳皇神罡：火鳳燎原
eng ao an	老僧挑擔 鳳皇神罡：火鳳燎原
ao eng ao an	老僧挑擔
e ao	九死邪功：奈何道 九死邪功：奈何道 開弓射雕
ong e ao	開弓射雕
ai ong e ao	開弓射雕
ing ou	惡毒蛇靈手 提壺敬酒
u ing ou	提壺敬酒
i u ing ou	提壺敬酒
ong ong	夢打銅鐘 拳打中宮 暗：殺手空空
a ong ong	夢打銅鐘 拳打中宮
an a ong ong	拳打中宮
ang ve	佛光普照金剛橛 望窗月 滅陽訣 豫嫇望月 霜雪
ang ang ve	望窗月
ou a	轉身扣殺
en ou a	轉身扣殺
an en ou a	轉身扣殺
u ong	十七式降龍掌：青龍出洞 單虎出洞 抽手護胸 毒蛇出洞 潛龍勿用 潛龍勿用 潛龍勿用 潛龍勿用 百劍無踪 紅級浮工 羅漢出洞 金剛出洞 降龍十八掌：青龍出洞 降龍十八腿：青龍出洞 雙狼出洞 雷虛忿怒怒空 青龍出洞 青龍出洞 青龍出洞 青龍出洞 青龍出洞 魔渡眾 黃級浮工
ou u ong	抽手護胸
ou ou u ong	抽手護胸
in an	千手百臂觀音亂 推分金拳 無敵金環 蛟龍臨淵 螳問心圈
en in an	推分金拳 螳問心圈
ei en in an	推分金拳
an ian	千焚萬煉 地網翻天 寶鴨穿蓮 掩護丹田 淚佛觀天 無間串蓮 狼斬天 若腿法：一念三千 藍燄 金剛一指：禪箭 開山鑑 霹靂戰天 龍纏綿
u an ian	掩護丹田 淚佛觀天
ian u an ian	掩護丹田
ing en	北斗冥王拳：魔冰盾 如來千佛手：轉法經輪 如來大手印：轉法經輪 蠍尾釘魂 驚神
o ing en	北斗冥王拳：魔冰盾
： o ing en	北斗冥王拳：魔冰盾
ong o	冥王蒼空破 天龍鎖 天龍鎖 天龍鎖 天龍鎖 蛟龍錯
ang ong o	冥王蒼空破
ang ang ong o	冥王蒼空破
ang o	伏妖降魔 冥王天翔破 左天羅降降羅 巨佛降魔 陰差陽錯 陰差陽錯 陰陽道：陰陽錯 陽火 雙雷盪魄
ian ang o	冥王天翔破
ang ian ang o	冥王天翔破
II ian	四指天 屍變 玄冰之箭
ing II ian	玄冰之箭
an ing II ian	玄冰之箭
ong u u ian	虎擺鶴雙形拳：龍虎出現
ang ong	九陽神功：移形分陽功 二虎藏踪 刀劍雙絕：一劍藏空 大無相功 日曜長空 易經降龍 火精當空 烈火焚陽功 無相功：小無相功 藏虎藏龍 血染長空 鐵殺拳：鐵血長空 霸王腿法：直搗黃龍 霹靂狂龍 霹靂狂龍 霹靂狂龍
u ang ong	二虎藏踪 大無相功 無相功：小無相功 藏虎藏龍
er u ang ong	二虎藏踪
ang u ang ong	藏虎藏龍
ei en ao ing	美人照鏡
ie eng	斜風 氣歪邪風 解夢
ang a	一倍大陽法 二鉗陽馬 卦玄擋煞 天狼殺 袖裡藏花 金剛甲
i ang a	袖裡藏花
ou i ang a	袖裡藏花
ong an	中嶽嵩山 天雷動拳 惡龍纏 惡龍纏 惡龍纏 惡龍纏 惡龍纏 指定中原 日字衝拳 毒龍鑽 毒龍鑽 箭腿毒龍鑽 虎嘯中原 連環衝拳 進馬衝拳 進馬衝拳 電光毒龍鑽 電光毒龍鑽 電光毒龍鑽 骨指：指定中原
ing ong an	指定中原 骨指：指定中原
II ing ong an	指定中原 骨指：指定中原
i ei	滅寂腿 烏龍戲水 遊龍戲水 遊龍戲水 闢地碎 風雲際會
ong i ei	烏龍戲水 遊龍戲水 遊龍戲水
u ong i ei	烏龍戲水
I II ian	四指天
ei ong	井中月&遁去的一配合任何內功 千雷歸宗 惡雷轟 搖龍歸洞 碎穹 穿橋歸洞 萬法歸宗 血火雷動 風舞雷動
ong ei ong	搖龍歸洞
ao ong ei ong	搖龍歸洞
u u	七級浮屠屠 子午珠 寒暑著 易筋經七級浮屠：紅級浮屠 火龍吐珠 火龍吐珠 烏龍吐珠 烽火烈拳：赤龍吐珠 玄壇伏虎 白級浮屠 紫級浮屠 般若伏伏 藍級浮屠 貝葉刀：慈航普渡 雄鷹撲兔 霸腿七式：一將功成萬骨枯 靈龍吐珠 青級浮屠 餓虎撲兔 餓鷹撲兔 鳥渡術 黃級浮屠 黑級浮屠
ong u u	火龍吐珠 火龍吐珠 烏龍吐珠 烽火烈拳：赤龍吐珠 靈龍吐珠
u ong u u	烏龍吐珠
an a	仙女散花 千軍萬馬 手扳丹蛙 鐵鎧戰甲 風箱拳法
ang an a	風箱拳法
eng ang an a	風箱拳法
a a	七逆寒天劫：寒麟化甲 伏羲畫卦 四平大馬 天地大法 浪濤沙沙 猛虎扒沙 虎虎抓沙 金禪袈裟 金禪袈裟 雙弓插花
ing a a	四平大馬
I ing a a	四平大馬
II ve	空懷日月 紅日訣 紅日訣 雙提日月
i II ve	雙提日月
ang i II ve	雙提日月
ou i i	不倒三擊：撼山抽屜地 切肉離皮 烏柔棄翼 頭霹靂
u ou i i	烏柔棄翼
ong a a	雙弓插花
ang ong a a	雙弓插花
a an ian	寶鴨穿蓮
ao a an ian	寶鴨穿蓮
u ai	單龍出海 殺器：殺器護體金剛不壞 煮海 神馳物外 逆天霸腿：顛雲覆海 鐵龍爪手：千龍出海 雙龍出海 雙龍出海 雙龍出海 雙龍出海 雙龍出海 雙龍出海 龍出海 龍形摩橋：雙龍出海
ong u ai	單龍出海 鐵龍爪手：千龍出海 雙龍出海 雙龍出海 雙龍出海 雙龍出海 雙龍出海 雙龍出海 龍出海 龍形摩橋：雙龍出海
ang ong u ai	雙龍出海 雙龍出海 雙龍出海 雙龍出海 雙龍出海 雙龍出海 龍形摩橋：雙龍出海
ing ao ang	金定橋相 鳳鳴朝陽
in ing ao ang	金定橋相
vn ao	左運運橋
vn vn ao	左運運橋
o vn vn ao	左運運橋
ao ve	水橋底撈月 海底撈月
i ao ve	水橋底撈月 海底撈月
ao i ao ve	水橋底撈月
ang ian	九陽神劍：少陽劍 元陽篇 六脈神劍：少商劍 商陽劍 大商劍 大陽劍 大陽劍 少商劍 少陽劍 殺破狼：餓狼天 莊嚴 霞盪劍 霸王斂 霹靂狂電
a ang ian	大商劍 大陽劍 大陽劍 霞盪劍 霸王斂
ong ao	兇暴 冰龍沖霄 冰龍沖霄 寒抱月霜結中霄 惡電沖霄 死氣沖霄 金鐘罩 雪泥鴻爪 飛鴻貓
ei ong ao	飛鴻貓
ao ie	石黑龍自創道：追魂五十滾攔腰劫 神亡消滅 雙劍橋切 高階
ian ao ie	雙劍橋切
ang ian ao ie	雙劍橋切
o ing	五輪金剛掌：天雷破嶺 坎雷過嶺 夜叉索命 左手破鼎 平步登天任我行 捕風捉影 潛麟過嶺 血火鼎 金楊破嶺 雲龍破嶺 雲龍破嶺 風神腿：捕風捉影 魍魎混元勁：第七重鬼索命
ou o ing	左手破鼎
o ou o ing	左手破鼎
er ai	右臂破兒排
o er ai	右臂破兒排
i o er ai	右臂破兒排
ong u	潛龍勿 煉爐烘爐 痛苦 破蓮八著：輕重著 碎金斷玉配合輕功：飛縱術 神龍降世配合步法：遊龍步 雙弓伏
ang ong u	雙弓伏
i ian	力限 洗臉 無影腳法：曇花一現 玉簪指：靈犀一點 疾電 脥底箭 迎佛西天 迎佛西天 迎佛西天 雷神疾電 青鑑秘卷：青氣現 驚虹一現
a ian i	十殺天地 白馬獻蹄 飛馬獻蹄 龍跨千里
ai a ian i	白馬獻蹄
ian u	伏虎連珠 借花獻佛 萬世流芳配合身法：蓮步 蛇形電步 蛇形電步 霜凝見絀
u ian u	伏虎連珠
u u ian u	伏虎連珠
I u u	子午珠
ao an ang	沉橋橋串掌
ao ao an ang	沉橋橋串掌
ei ian	天外飛仙 指尾天 毀天 紫電天羅：雷電 蠍尾飛鞭 追電 霸碎天
II ei ian	指尾天
an ao	五毒邪元爪 坐馬單橋 拳道 拳道 玄陰鬼爪：夜叉探爪 萬劫難逃 蜂毒貫腦 銀戰袍 鷹旋刀
a an ao	坐馬單橋 玄陰鬼爪：夜叉探爪
o a an ao	坐馬單橋
a u ang	進馬出掌
in a u ang	進馬出掌
an u u	寒暑著 玄壇伏虎 霸腿七式：一將功成萬骨枯
an an u u	玄壇伏虎
ang u ong	金剛出洞 雙狼出洞
in ang u ong	金剛出洞
ian II	天式 女媧煉石 拳箭腿：後發先至 暗無天日 滔天勢 疾電勢 疾電式 竹連枝 純陰玄天指 陰陽指：純陽幹天指 飛云四式：雲開見日
u ian II	暗無天日 竹連枝
vn e	草尋蛇
ao vn e	草尋蛇
ao ou	十三象：撕心肺龍爪手 幻魅妖球 水浪拋球 浪裡拋球 貫嘯手 龍拳：龍爪手 龍爪手 龍爪手
i ao ou	浪裡拋球
ang i ao ou	浪裡拋球
i ou	寒冰霹靂球 混元霹靂手 紫氣天羅：紫氣收 觀空大劈手 魁星踢鬥
ing i ou	魁星踢鬥
ei ing i ou	魁星踢鬥
ai o	漢拜佛 雙弓抱月童子拜佛 雲海波
I ai o	雙弓抱月童子拜佛
ong I ai o	雙弓抱月童子拜佛
ang v	猛虎負雙隅
u ang v	猛虎負雙隅
u u ang v	猛虎負雙隅
ian ao ei	虎眼豹捶
u ian ao ei	虎眼豹捶
i ao an	獨臂橋單
u i ao an	獨臂橋單
a ong an	進馬衝拳 進馬衝拳
in a ong an	進馬衝拳 進馬衝拳
ian I	單工千字 工千字 百媚千姿
ong ian I	單工千字 工千字
an ong ian I	單工千字
ei a	三落梅花 甲骨功：龜甲 連環罪把 雙掛捶法 雙掛捶法 魔骷甲：龜甲
a ei a	雙掛捶法 雙掛捶法
ang a ei a	雙掛捶法 雙掛捶法
ei o	右地網：天修墜落 天雷過 掛捶落 掛捶落 穹天赤雷破 雷霆魔功：驚雷破 青城金剛拳：沉雷破
a ei o	掛捶落 掛捶落
u i an	獨臂單
ong I	單工字 雙千工字
an ong I	單工字
ian ong I	雙千工字
ang ian ong I	雙千工字
ian an	元空天轉 八分箭拳 合縱連環 天關 崆峒神通拳：三通連環 張果老醉酒拋杯踢連環 斜側削妙炒四法：前鏟 日月天殘 火箭拳 火豹連環 火龍千轉 蝶掌連環 豹豹子連環 通天拳 魔鬼四絕手：慘絕人寰扣連環 麟霸千山
ong ian an	元空天轉 合縱連環 崆峒神通拳：三通連環 火龍千轉 通天拳
ong ian	一飛沖天 中衝劍 九幽逆經奇功：紅焰 再生鳳吼沖天 冰鎖虛空煉 冰鎖虛空煉 大衝劍 少衝劍 少衝劍 暴雷轟天 滅水空焰 火焰神功：紅焰 環捶通天 蒼龍動天 血道殺拳：血沖天 鐵龍剪 鐵龍剪 關衝劍 雄鷹沖天 雙箭擊通天 飛龍天
ei ong ian	一飛沖天 暴雷轟天 滅水空焰 環捶通天 飛龍天
an ei ong ian	環捶通天
en ian an	八分箭拳
a en ian an	八分箭拳
ai en a	還魂法
ao I	吊腳字 撥繭挑絲
ao ao I	吊腳字
an u	不間斷亂舞 乾隆亂舞 兩儀劍烈陽級：天蠶縛 天魔亂舞 方圓著 明暗著 火鳳亂舞 狂風亂舞 狂龍亂舞 繁花似蘭芟鋤 群龍亂舞 群龍亂舞 群龍亂舞 群龍亂舞 轉身散竹 邪魔亂舞 降龍十八掌：龍亂舞 鷹群亂撲 龍亂舞
en an u	轉身散竹
an en an u	轉身散竹
ian ei	五雷化殛手：五滅天雷 滅天雷 煉髓 神龍剪水 萬箭錐 轟天雷 鐵千門千捶 雙龍剪水 雙龍剪水 霹靂天雷 馭電追
en ian ei	鐵千門千捶
ian en ian ei	鐵千門千捶
ei ei	刁鑽詭裂龍尾腿 想入非非 蝴蝶飛飛 追悔 霜痕累累
ie ei ei	蝴蝶飛飛
u ie ei ei	蝴蝶飛飛
in ang	二轉陰陽 十心掌 羅殿裡判陰陽 雙鷹擒蟒 餓虎擒羊 餓豹擒狼
u in ang	餓虎擒羊
e u in ang	餓虎擒羊
u u ong	單虎出洞 雷虛忿怒怒空
an u u ong	單虎出洞
u a an	虎虎下山
u u a an	虎虎下山
ai ang	神伏州魔訣：驚濤白浪 虎憑豺狼
ing ai ang	虎憑豺狼
u ing ai ang	虎憑豺狼
ai a ao	帶馬槽
an an a	手扳丹蛙
ou an an a	手扳丹蛙
i in	一心碧印 摔蒲麒麟 洗心 移勁
u i in	摔蒲麒麟
ai u i in	摔蒲麒麟
ou en ao	歸手沉腰
ei ou en ao	歸手沉腰
en i	三元氣功：長生訣真氣 人極 人極 先天純陽真氣 天魂殛 手問題 痴心魂離 長生訣：先天純陰真氣
ou en i	手問題
ang ao ou	水浪拋球
ei ang ao ou	水浪拋球
ong ei	八龍匯 扭馬衝捶 日字衝捶 炙手轟雷 烏龍尾 猛虎裡衝捶 百獸同悲 神龍尾 迷踪腿 鷹旋萬里空碎
i ong ei	猛虎裡衝捶 迷踪腿 鷹旋萬里空碎
u i ong ei	猛虎裡衝捶
e ei en	擺鶴嘴沉
ai e ei en	擺鶴嘴沉
ao e	狂蜂暴蜇 還右飽鶴
ou ao e	還右飽鶴
ai ou ao e	還右飽鶴
ei e	獨腳飛鶴
ao ei e	獨腳飛鶴
u ao ei e	獨腳飛鶴
ve e	殘腳缺鶴
ao ve e	殘腳缺鶴
an ao ve e	殘腳缺鶴
vn a	仙鶴尋蝦 餓鶴尋蝦
e vn a	仙鶴尋蝦 餓鶴尋蝦
e e vn a	餓鶴尋蝦
ing a	奪命殺 左鶴頂法 雁落平沙 飛龍頂壓 鶴頂法
e ing a	左鶴頂法 鶴頂法
o e ing a	左鶴頂法
u ong ei	烏龍尾
ai II	不死七幻：以虛還實 火龍拜日 石破天氣蓋世 羅漢曬屍 羅漢曬屍
an ai II	羅漢曬屍 羅漢曬屍
o an ai II	羅漢曬屍 羅漢曬屍
in u	分筋骨 卞崖擒虎 獸心怒 蝕骨春宵配合毒功：陰陽毒功陰毒 走麒麟步
a in u	卞崖擒虎
ian a in u	卞崖擒虎
a ian	天煞地氣功：地煞篇 天煞篇 海網撒天 醉酒八仙
ou a ian	醉酒八仙
ei ou a ian	醉酒八仙
an u ong	羅漢出洞
o an u ong	羅漢出洞
II ou	單指手 天魔功：天魔四蝕：天魔蝕肉 詠春黐手
an II ou	單指手
ing ao ei	一星拋捶
i ing ao ei	一星拋捶
ao ao ei	二星桃拋捶 沖天豹豹捶
ing ao ao ei	二星桃拋捶
an ei a	連環罪把
ian an ei a	連環罪把
an ou	千鷹萬壽 斷肢斬首 烈火斷頭 翻兜 虹斷流 詠春按手 詠春攤手 連環扣 鐮刀斷頭 鐵鵬斬首 陰綿綿掌：絲絲玄扣
ian an ou	連環扣
ian i ian	脥底箭
ao a	勾彈腳法 大爆炸 黑虎爪法
an ao a	勾彈腳法
ou an ao a	勾彈腳法
an o ian	連環火箭
ian an o ian	連環火箭
ao ao	宓，虛無物無相生，陀相成份與物忘，同混涅天無天涯，萬物齊乎花落葉，虛若若般，千愁憂，才下心頭即展眉頭，靈臺清幽心掛無憂，谷意無所執執心幽釋神，莫無魂千般憂，才下心頭即展眉頭，靈臺清，水流心不驚，雲贅在意具遲一心不物，古今自逍遙 怒月暴潮 曹國手指雲陽見板左右摔倒在高橋 絞絞 鐵掃腳 青濤嘯 驕陽耀耀
ie ao ao	鐵掃腳
ou I	猴子
u ao a	黑虎爪法
ei u ao a	黑虎爪法
ian ao	人間道 千浪千濤 大聖朝天腳 天招 天道 毒刺腿：百蜇千螯 無間道 猴王獻爪 蒼狼四絕：風沙霸拳：狼王壓頂朔漠天刀 金龍獻爪
ong ian ao	金龍獻爪
in ong ian ao	金龍獻爪
en in	不動根本印 不動根本印 佛問珈藍轉法輪印 佛問迦藍轉法輪印 十字分金 密宗神功：大日輪印 截脈寸勁 脈分筋 金頂佛燈不動根本印 金頂佛燈不動根本印 鐵掌分金
I en in	十字分金
II I en in	十字分金
ing ao	叱吒風雲霸凌霄 血雨晶刀 金星角 靈霄 鷹爪 鷹翱
in ing ao	金星角
u ou an	騎虎搜山
i u ou an	騎虎搜山
eng ian	日字猛箭 銀月聖典 飛云四步：一步登天 餓狼聲天
I eng ian	日字猛箭
II I eng ian	日字猛箭
o ing a	奪命殺 雁落平沙
ian o ing a	雁落平沙
u ie	以身入滅 工況：初階 無遠弗屆 空空如也 長生不滅 雙飛蝴蝶 骨裂
ei u ie	雙飛蝴蝶
ang ei u ie	雙飛蝴蝶
a ong ei	八龍匯 扭馬衝捶
ou a ong ei	扭馬衝捶
i in u	走麒麟步
ou i in u	走麒麟步
ie ang	之字蝶掌 有影皆雙
I ie ang	之字蝶掌
II I ie ang	之字蝶掌
ang ian an	蝶掌連環
ie ang ian an	蝶掌連環
ou ao	丹影手腳 九幽爪 凶獸道 心驚肉跳 殺龍求道 空手道 裂頭腳
ing ou ao	丹影手腳 心驚肉跳
an ing ou ao	丹影手腳
u ve	底無堅不決 怒碎五嶽 蓉莛暮雪 龍藏虎躍 龍遊勝五嶽
ang u ve	龍藏虎躍
ong ang u ve	龍藏虎躍
u a a	猛虎扒沙 虎虎抓沙
eng u a a	猛虎扒沙
ao ang an	虎豹雙拳
u ao ang an	虎豹雙拳
ao ei ong	穿橋歸洞
an ao ei ong	穿橋歸洞
an ong u ai	單龍出海
i ing	冰心訣：心若冰清，天墜不驚，萬變猶定，神怡氣靜 刁打七星 孤只泥影 日月神鑑：陰世奇經 虎鶴齊鳴 陽世奇經 龍潛迷冰 龍潛迷冰
e i ing	虎鶴齊鳴
u e i ing	虎鶴齊鳴
en ou	四步神遊 海市蜃樓 血河奔流 詠春問手 詠春手 詠春拳：詠春手 迷竅毒掌：斷腸溫柔 醉眼看天庭擎槍指神州 金絲掌：黃天當立震神州
ong en ou	詠春手 詠春拳：詠春手
： ong en ou	詠春拳：詠春手
en an ou	詠春按手 詠春攤手
ong en an ou	詠春按手 詠春攤手
u ou	千株萬毒手 神風怒吼 群龍無首 詠春伏手 龍無首
en u ou	詠春伏手
ong en u ou	詠春伏手
en en ou	詠春問手 金絲掌：黃天當立震神州
ong en en ou	詠春問手
en II ou	詠春黐手
ong en II ou	詠春黐手
a ou	拈衣擒拿手 詠春殺手 閻王十殺令：剝皮挖肉 鷹爪抓手
en a ou	詠春殺手
ong en a ou	詠春殺手
ao ian ou	詠春小念頭
en ao ian ou	詠春小念頭
a in	三倍大陰 殺拳：殺心 短程發勁 紫煞勁 赤手兇拳：鐵劃銀 迎佛西天日光菩薩印 鷹爪挖心 鷹爪挖心
eng a in	短程發勁
an eng a in	短程發勁
ou u ao	並右步標
ing ou u ao	並右步標
en II	五轉分屍 以身試 冥爪分屍 大鷹振翅 惡龍吞日 斬星河困勢 真魔天道：斬鐵暴風殺血魅邪魂劫封神虎殺陣：封神式 詠春指 鋼羽煞氣爪：啄肉分屍
ong en II	惡龍吞日 詠春指
ao ang ei	標雙飛 金豹雙捶
ian ang a	二鉗陽馬 天狼殺
er ian ang a	二鉗陽馬
I o ou	側身右字過肘
ou I o ou	側身右字過肘
II a	側身鉗陽指馬 分屍殺
ang II a	側身鉗陽指馬
ian ang II a	側身鉗陽指馬
ai ei	拖帶水 神龍擺尾 神龍擺尾 神龍擺尾 神龍擺尾 神龍擺尾 神龍擺尾 神龍擺尾 神龍擺尾 神龍擺尾 神龍擺尾 蝎子洞擺尾 蠍鞭腿：蝎子擺尾 貼身快腿
en ai ei	貼身快腿
ie en ai ei	貼身快腿
I ong an	日字衝拳
II I ong an	日字衝拳
I ong ei	日字衝捶
II I ong ei	日字衝捶
an ong an	連環衝拳
ian an ong an	連環衝拳
en ao ang	詠春標掌
ong en ao ang	詠春標掌
i ang	二陽霹靂掌 火舞激揚 狂蜂飛釀蜜忙 詠春劈掌 霹靂象
en i ang	詠春劈掌
ong en i ang	詠春劈掌
ei ang	九死輪迴大法：餓獸鬼王 北冥飛傷 千眼鬼王 地藏鬼王 振翅飛揚 森羅鬼王 沉雙雙推掌 無界鬼王 瘟疫鬼王 百蟲鬼王 追浪 陰陽鬼王 雷象 電光鬼王
ang ei ang	地藏鬼王 沉雙雙推掌 陰陽鬼王 電光鬼王
ang ang ei ang	沉雙雙推掌
ai en in	截脈寸勁 脈分筋
ie ai en in	截脈寸勁
i u ao	剔骨道 剔骨道 無道拳：地無道
： i u ao	無道拳：地無道
ang u ao	九陽普照 佛光普照 佛光普照 烈陽普照 烈陽神掌：烈陽普照 狂無道 陰陽三式：陰陽毒爪
a u ao	殺無道
en ei	七轉輪迴 九死白骨爪：再世輪迴 朱雀恨水 無界拳：粉碎 無盡輪迴 達摩神腿 離恨分飛 雷電分飛 電光分飛 魔佛佛輪迴 魔光七重天：魔光綻放春雷
： en ei	無界拳：粉碎
an ： en ei	無界拳：粉碎
ie ian	滅煙
： a in	殺拳：殺心
an ： a in	殺拳：殺心
a en	殺神
a ve	殺絕 驅盡殺絕
an ：	五形拳： 天霜拳： 少林羅漢拳： 睡羅漢：
ing an ：	五形拳：
u ing an ：	五形拳：
e e	火螳割禾 虎形：猛虎出射蛇
u e e	虎形：猛虎出射蛇
u u e e	虎形：猛虎出射蛇
u u u	七級浮屠屠 餓虎撲兔
e u u u	餓虎撲兔
u in	九陰寒屍功：碎骨勁 內縛印 千刀不盡 千手佛印 昂首吐信 毒蛇吐信 火蛇吐信 火蛇吐信 遙極樂功：採陽補陰 霹靂龍虎勁 黑虎偷心蛇形：白蛇吐信
e u in	毒蛇吐信 火蛇吐信 火蛇吐信 黑虎偷心蛇形：白蛇吐信
ai e u in	黑虎偷心蛇形：白蛇吐信
an ong	一念圓融 十三龍 密宗金剛腿：金剛盤龍 明交暗融 梅花三弄 百毒千手掌：毒蟲鑽洞 錦花三弄 靈蛇鑽洞 飛鷹盤空
e an ong	靈蛇鑽洞
ing e an ong	靈蛇鑽洞
ong ai ao	毒尾龍形：金龍擺爪
in ong ai ao	毒尾龍形：金龍擺爪
ong ong ian	中衝劍 蒼龍動天
ang ong ong ian	蒼龍動天
eng ong	二步橫空 殛電橫空 毒蟒橫空 神龍出海：飛鶴騰空 血橫空 鐵家雷拳：雷橫空 雲風湧 雷電橫空 雷電橫空
e eng ong	神龍出海：飛鶴騰空
ei e eng ong	神龍出海：飛鶴騰空
ian e vn a	仙鶴尋蝦
ong ao ei	還魂飽鶴形：雙動豹錘
ang ong ao ei	還魂飽鶴形：雙動豹錘
I ian an	豹豹子連環
ao I ian an	豹豹子連環
a ou ing	豹打流星
ao a ou ing	豹打流星
an ou i i	不倒三擊：撼山抽屜地
ong ao ou	十三象：撕心肺龍爪手 龍拳：龍爪手 龍爪手 龍爪手
： ong ao ou	龍拳：龍爪手
ong o ian	龍破天
ing ang II II	鷹王噬日
ong i	七箭碎中極 九龍壁 冰天凍地 刻骨離裸配合步法：無刻痕踪跡 雷火動地
ou ong i	九龍壁
II ong u u	烽火烈拳：赤龍吐珠
ian o	五道邪元：千破 天羅天羅 天魔舞：小天魔 火網天羅 火網天羅 盤古擊：開天破 紫氣天羅
ang ian o	火網天羅 火網天羅
o ang ian o	火網天羅 火網天羅
en ian	九陽神劍 崑崙劍 暴焰焚天 曦萬輪千 混沌劍 火尊訣：太極真焰 火虹焚天 火龍吞天 火龍吞天 炎陽奇功：太火焚天 焚天 煮海焚天 禦火吞天 藍采和度沈痾收花把子湘分獻 血火沉天 達摩神劍 雷震天 電震天 骨分肩
ian en ian	暴焰焚天 電震天
ao ian en ian	暴焰焚天
en ing	楚莊王中原問鼎 虎嘯皇拳：一紅塵驚 血神凝
ong en ing	虎嘯皇拳：一紅塵驚
i ong en ing	虎嘯皇拳：一紅塵驚
ai an	乾坤絕絕無量/乾坤無定震動百里：乾坤原：天道：雷動九天火燎坤：天驚地循環：風兮破天驚地：水兮滔天火兮焚野山兮鬼神驚：岳東泰山 偏勞法概全 再嘯嘯湖海翻 千漩百轉 或在淵 或躍在淵 或躍在淵 或躍在淵 或躍在淵 推山手：五丁開山 泰拳 烈火開山 直排斬 閻王掌：閻王開山 龍躍在淵
u ai an	再嘯嘯湖海翻
ao u ai an	再嘯嘯湖海翻
en an	三鬼神探 兩極心法：人關 煉火焚拳 神關 紫陽神拳 聖火神拳
ei en an	三鬼神探
an ei en an	三鬼神探
ang ie	絕穹蒼滅 鐵拐撞鐵
ong ang ie	絕穹蒼滅
ve ong ang ie	絕穹蒼滅
ie a in	赤手兇拳：鐵劃銀
： ie a in	赤手兇拳：鐵劃銀
ong ang	八方龍王 氣奪穹蒼 氣蓋穹蒼 穹蒼 蒼穹血穹蒼 蛟龍江 血雨歸穹蒼 赤壁銅牆 金穹蒼 鎖龍網 鐵臂銅牆 陽斷穹蒼 靇象
i ong ang	赤壁銅牆 鐵臂銅牆
II i ong ang	赤壁銅牆
ou ei	二十三式降龍掌：亢龍有悔 亢龍有悔 修羅無極修腿 劫有為 等龍有悔 群龍有悔 裡勾雷 降龍十八掌：亢龍有悔 降龍十八掌：亢龍有悔 降龍十八掌：亢龍有悔 降龍十八掌：亢龍有悔
i ou ei	修羅無極修腿 裡勾雷
ian ong	臥虎潛龍
u ian ong	臥虎潛龍
o u ian ong	臥虎潛龍
o i	十刀破極 十萬火急 水挪移 火級 火級 白駒過隙 菩薩滅如來破：如來破極 萬物如我意 萬軍莫敵
vn o i	萬軍莫敵
an vn o i	萬軍莫敵
o en an	煉火焚拳 聖火神拳
ian o en an	煉火焚拳
II a ian i	十殺天地
an i	三箭斷璇璣 五星戰神氣：土星戰氣 斧玄擊 木星戰氣 橫死三式：小安息 水星戰氣 滅神三極 火星戰氣 火雲萬里 無形暗器 神鷹奪：鷹揚萬里 藍級 金星戰氣 龍群萬里 龍萬里
ao an i	橫死三式：小安息
： ao an i	橫死三式：小安息
ie o	大解脫
a ie o	大解脫
i e	天造地設 天魔極樂 早登極樂 終極樂 雷電覓嗑
ong i e	終極樂
in eng	陰風烈陽拳：暴烈陰風
ie in eng	陰風烈陽拳：暴烈陰風
ao ie in eng	陰風烈陽拳：暴烈陰風
ie ang u ao	烈陽普照 烈陽神掌：烈陽普照
ao i	陰陽交擊
ang ao i	陰陽交擊
in ang ao i	陰陽交擊
en ei o	青城金剛拳：沉雷破
： en ei o	青城金剛拳：沉雷破
ai an ian	開山鑑
ong ian i	轟天擊 轟天殛 雷動天地
an ian ei	萬箭錐
in ang an	密宗金剛拳 金剛鑽 金剛鑽
ang an ：	天霜拳：
ian ang an ：	天霜拳：
ang u ian	佛光初現 天佛掌：佛光初現 如來神掌：佛光初現 穹蒼無邊 達摩神劍：佛光初現 雷電神腿首六式：電光初現 雷電神腿：電光初現 雷電神首腿：電光初現 風霜霜撲面
ang ang u ian	風霜霜撲面
ie ong ao	寒抱月霜結中霄
ang ie ong ao	寒抱月霜結中霄
ang e	當頭棒喝 雪紛飛霜冷長河
eng ang e	雪紛飛霜冷長河
ang eng ang e	雪紛飛霜冷長河
en ei ei	霜痕累累
ang en ei ei	霜痕累累
ing ian u	蛇形電步 蛇形電步 霜凝見絀
ang ing ian u	霜凝見絀
ing o u	披霜凌撥露 爭明奪目
ang ing o u	披霜凌撥露
u eng	傲雪霜：傲立孤峰 勢步城 大夢神功：入夢 輪迴轉苦生 金頂佛燈 金頂佛燈
i u eng	傲雪霜：傲立孤峰
ao i u eng	傲雪霜：傲立孤峰
vn ei	捷若迅雷 雪嶺尋梅
ing vn ei	雪嶺尋梅
ve ing vn ei	雪嶺尋梅
vn a ing	凌雲壓頂
ing vn a ing	凌雲壓頂
v ao ing	霜霜河倒影配合步法：霜履薄冰
ang v ao ing	霜霜河倒影配合步法：霜履薄冰
ve ang ong	鐵殺拳：鐵血長空
ie ve ang ong	鐵殺拳：鐵血長空
ve u ang	鐵血無雙
ie ve u ang	鐵血無雙
II u II	狂獅逐日
ang II u II	狂獅逐日
ang a ao	鐵血狂殺道
ve ang a ao	鐵血狂殺道
ou in u	獸心怒
ou in	五行豹拳：土豹投林 千投林 大金剛輪手印 大黑天手印 如來大手印 火烙手印 血手印 釜抽薪 鐵沙虎爪功：爪偷心 黑龍偷心 黑龍偷心 黑龍偷心 黑龍偷心 黑龍偷心 黑龍偷心
ao ou in	五行豹拳：土豹投林 火烙手印 鐵沙虎爪功：爪偷心
u ao ou in	五行豹拳：土豹投林
ao ian an	火豹連環
o ao ian an	火豹連環
in ao ang ei	金豹雙捶
ie en	滅王拳：滅神
： ie en	滅王拳：滅神
an ： ie en	滅王拳：滅神
a u	殺佛 蛇打霧 蛇打霧 雲游太虛配合步法：八卦步 魔光陽大暑
ie u ang	涅槃七劫拳：劫無相
： ie u ang	涅槃七劫拳：劫無相
ie ou ei	劫有為
ie u ian	劫如電
an an ：	少林羅漢拳：
o an an ：	少林羅漢拳：
an ai o	漢拜佛
o u ao	倒如來降魔伏妖 金鑼普照
ang o u ao	倒如來降魔伏妖
an o ou	笑羅漢醉羅漢：醉拳鎖手
ei an o ou	笑羅漢醉羅漢：醉拳鎖手
o an ：	睡羅漢：
ei o an ：	睡羅漢：
u en ao	懶佛伸腰 第八重鬼哭鬼哭神號
an u en ao	懶佛伸腰
ei an	九陰真經：九陰歸元 人造雷拳 印度海劍合招：七劍歸元 地關碧綠內丹 天關赤紅內丹 澤地歸元 烈旋水轉 熊掌推山 狂雷鑽 瘋羅睡漢 紫氣歸元 萬劍歸元 蕩氣迴旋 鐵沙神掌：鐵牛推山 魔典真經：人關紫藍內丹
o ei an	瘋羅睡漢
eng o ei an	瘋羅睡漢
ian o an	天羅漢 心錐：炎火鑽
ai a	不壞金身：琉璃鎧甲 大聖門神力功：猴王摘茄 將軍令：銅鎧甲 絕代殺 舍利鎧甲 驚雷鎧甲
ang ai a	大聖門神力功：猴王摘茄
ou ang ai a	大聖門神力功：猴王摘茄
ao ian ao	大聖朝天腳
eng ao ian ao	大聖朝天腳
ang ian ao	千浪千濤 猴王獻爪
ou ang ian ao	猴王獻爪
ei i	十陽歸一 死心墜地 水級 水級 烈火飛膝 無量為一 神力飛膝 級浮黑級 追雲腿：雲現踪霏迷
i ei i	神力飛膝
en i ei i	神力飛膝
an ong ian an	元空天轉 崆峒神通拳：三通連環
ian ei o	天雷過
ing ei en	驚雷震
ing ong u u	靈龍吐珠
ve ong ian	血道殺拳：血沖天
： ve ong ian	血道殺拳：血沖天
ve ian i	血淹地
ve eng ong	血橫空
ei eng ong	鐵家雷拳：雷橫空
： ei eng ong	鐵家雷拳：雷橫空
ei ong an	天雷動拳
ian ei ong an	天雷動拳
ei en ian	雷震天
e ei ong	井中月&遁去的一配合任何內功 惡雷轟
ao ei an	人造雷拳
en ao ei an	人造雷拳
ei ong ian i	雷動天地
ing ou ian	雷行九天
ei ing ou ian	雷行九天
ang ei an	熊掌推山 狂雷鑽
ei u ao	暴雷誅妖
ao ei u ao	暴雷誅妖
i a	九霄真經：霓霞 兩極甲 動地殺 千手銅拳：千鈞一發 雷冥空霸四絕：鬼劈霸
vn i a	千手銅拳：千鈞一發
ian vn i a	千手銅拳：千鈞一發
ei ai ian	千錘百煉
ian ei ai ian	千錘百煉
ian ang ian ao	千浪千濤
vn an a	千軍萬馬
ian vn an a	千軍萬馬
ao en ao	兇豹殺拳：懶豹伸腰 妖魂霄
an ao en ao	兇豹殺拳：懶豹伸腰
ao in ang	餓豹擒狼
e ao in ang	餓豹擒狼
an in	兩極冰火螺旋勁：長生烈火螺旋勁 惡穿心 歸元勁 毒蠍穿心 碎骨穿心 移陽轉陰 萬箭穿心 逍遙令神功：鍛筋 鍛筋 長生冰火螺旋勁：長生烈火螺旋勁 長生寒冰螺旋勁
e an in	惡穿心
ian ao ao ei	沖天豹豹捶
ian ou in	千投林 大黑天手印
o II u	七十二路空明拳：左右互搏之術 天魔蝕骨
u o II u	七十二路空明拳：左右互搏之術
ou ao an	凶獸暴拳
ong ou ao an	凶獸暴拳
an ei	六轉腿 千手拳：天花亂墜 天殘三絕：天殘腿 天花亂墜 天花亂墜 寒刀斷水 旱雷 禪雷 陰世幻腿
a an ei	千手拳：天花亂墜 天花亂墜 天花亂墜
ian a an ei	千手拳：天花亂墜 天花亂墜 天花亂墜
ong ou ao	凶獸道 殺龍求道 空手道
v an	四箭破巨關 櫺豫金指：櫺霏玉嬋 魚躍於淵 鷹咀拳 龍躍於淵
ing v an	鷹咀拳
in in	佛動山河天鼓雷音印 佛動山河天鼓雷音印 千乘萬宮高浪重湧臨臨 如來神掌：一心印
i in in	如來神掌：一心印
： i in in	如來神掌：一心印
ing in	佛光初現光聚佛頂印 佛法無邊成就一切明印 光聚佛頂印 刻骨銘心 戰鼓鳴金 長生寒冰勁
u ing in	佛光初現光聚佛頂印 光聚佛頂印 刻骨銘心 戰鼓鳴金
v u ing in	佛光初現光聚佛頂印 光聚佛頂印
en en in	不動根本印 不動根本印 金頂佛燈不動根本印 金頂佛燈不動根本印
ong en en in	不動根本印 不動根本印 金頂佛燈不動根本印 金頂佛燈不動根本印
ei in in	佛動山河天鼓雷音印 佛動山河天鼓雷音印
u ei in in	佛動山河天鼓雷音印 佛動山河天鼓雷音印
a en in	佛問珈藍轉法輪印 佛問迦藍轉法輪印
an a en in	佛問珈藍轉法輪印 佛問迦藍轉法輪印
u a in	迎佛西天日光菩薩印
ang u a in	迎佛西天日光菩薩印
in ang ve	佛光普照金剛橛
ao in ang ve	佛光普照金剛橛
ang in	九陰寒屍：反盪勁 伏妖金剛印 天佛降世智吉祥印 心掌：心箭雙印 旋風太陽勁 烈陽勁 般若神掌：金剛印 軒轅三罡神功：風罡勁 金剛印 雷罡勁 電罡勁 魔佛血狂臨
i ang in	天佛降世智吉祥印
II i ang in	天佛降世智吉祥印
ie ing in	佛法無邊成就一切明印
i ie ing in	佛法無邊成就一切明印
u ao ong	萬佛朝宗 萬佛朝宗 萬佛朝宗
an u ao ong	萬佛朝宗 萬佛朝宗 萬佛朝宗
o ang u ian	佛光初現 天佛掌：佛光初現 如來神掌：佛光初現 達摩神劍：佛光初現
ai ong	佛抱懷容 冰海龍 冰海龍 火龍在空 百發百中
ao ai ong	佛抱懷容
u ao ai ong	佛抱懷容
u i ian	迎佛西天 迎佛西天 迎佛西天
ing u i ian	迎佛西天 迎佛西天 迎佛西天
o ang u ao	佛光普照 佛光普照
a u ian	佛法無邊 佛法無邊 達摩神掌：佛法無邊
o a u ian	佛法無邊 佛法無邊 達摩神掌：佛法無邊
ang II	一陽指 不滅鳳凰勢 八步穿陽指 回網勢 天佛降世 奇蹟金剛指 暗空神訣：蒼狼勢 浪勢 無弓放矢 無的放矢 神佛降世 結網勢 翻江勢 貪狼日 餓狼噬
o ang II	神佛降世
en o ang II	神佛降世
an e	一器動山河 佛動山河 佛動山河 佛動山河 拔山河 碎山河 電爪戰車
ong an e	一器動山河 佛動山河 佛動山河 佛動山河
u ong an e	佛動山河 佛動山河 佛動山河
en eng u	捨身成佛
e en eng u	捨身成佛
ing u eng	金頂佛燈 金頂佛燈
in ing u eng	金頂佛燈 金頂佛燈
en a an	佛問迦藍 佛問迦藍
u en a an	佛問迦藍 佛問迦藍
u ang II	天佛降世
ian u ang II	天佛降世
u an	佛掌：大羅佛圈 天網復原 屍骨如山 慘無慘 或躍入淵 漢鐘醉步壇 烈陽毒拳 煉骨關 生靈塗炭 羝羊觸藩 鐵布衫
o u an	佛掌：大羅佛圈
a o u an	佛掌：大羅佛圈
u en a	佛祖問法
o u en a	佛祖問法
ou u in	千手佛印 昂首吐信
ian ou u in	千手佛印
eng o	大須彌掌：立地成佛 捕風捉
i eng o	大須彌掌：立地成佛
i i eng o	大須彌掌：立地成佛
ian ang in	心掌：心箭雙印 電罡勁
in ian ang in	心掌：心箭雙印
in ian	心變 扣人心弦 掌心電 日輪印前
en in ian	扣人心弦 日輪印前
ou en in ian	扣人心弦
in ei i	死心墜地
I in ei i	死心墜地
ian an in	萬箭穿心
an ian an in	萬箭穿心
ie ong	四大皆空 火雲掌：火雲鐵桶
vn ie ong	火雲掌：火雲鐵桶
o vn ie ong	火雲掌：火雲鐵桶
o e u in	火蛇吐信 火蛇吐信
an an	五行八卦掌：終日干幹 冰剮萬斬 冰剮萬斬 刻骨無骨折斷腕 劍傲英雄禮道：盛意拳拳 宇宙身法：身光玄閃 巨蟒盤纏 漢鍾離手使陽寶扇扇 火龍穿山 火龍穿山 王婆扇扇 生離死別催肝幻 紫旋龍捲纏 終日干幹 終日干幹 終日干幹 終日干幹 血劫爪：千劫萬難 銀弧斷斷 銅像功：銅拳：銅砲穿山
ong an an	火龍穿山 火龍穿山 紫旋龍捲纏
o ong an an	火龍穿山 火龍穿山
ai ing	七路翻雲手：裂雲摘星 排雲摘星 火雲蓋頂 火雲蓋頂 穿雲摘星
vn ai ing	七路翻雲手：裂雲摘星 排雲摘星 火雲蓋頂 火雲蓋頂 穿雲摘星
o vn ai ing	火雲蓋頂 火雲蓋頂
ai u ian	火海無邊 火海無邊 白虎天 苦海無邊
o ai u ian	火海無邊 火海無邊
o ao an	地火燎原 地火燎原 聖火燎原 離火燎原 鬼火燎原
i o ao an	地火燎原 地火燎原 離火燎原
en eng	天火焚城 天火焚城 天火焚城 萬馬奔騰 萬馬奔騰 衝千魂城 赤蓋焚城 鐵沙焚城
o en eng	天火焚城 天火焚城 天火焚城
ian o en eng	天火焚城 天火焚城 天火焚城
ong II	冰玄凍空時 火雲掌：火龍式 狂麟凍噬
o ong II	火雲掌：火龍式
： o ong II	火雲掌：火龍式
ao i i	霹靂神掌：九陽小霹靂
ang ao i i	霹靂神掌：九陽小霹靂
e i	九陽大霹靂合招：雙陽合璧 兩極歸元天地合一 寶瓶印合招：真言九印合一 聖帝舍利 離踝關節折翼
ang e i	九陽大霹靂合招：雙陽合璧
ang ang e i	九陽大霹靂合招：雙陽合璧
ou ian i	天地玄掌：氣遊天地 天外逍遙篇：氣遊天地
i ou ian i	天地玄掌：氣遊天地 天外逍遙篇：氣遊天地
ing i	地轉星移 奇門遁甲：斗轉星移 斗轉星移 連環魁星踢 雪冰：冰劈 青氣
an ing i	地轉星移 奇門遁甲：斗轉星移 斗轉星移
ou an ing i	奇門遁甲：斗轉星移 斗轉星移
ian en	乾坤 乾坤 乾坤裂山腿：倒轉乾坤 大日紫氣：電鎖乾坤 太玄神指：指定乾坤 如意電震 意守乾坤 易轉乾坤 無殛電輪 聞風先遁 觀心千手震乾坤 變身 逆亂乾坤 雷霆電震 霹靂電震
an ian en	乾坤裂山腿：倒轉乾坤 易轉乾坤 逆亂乾坤
i an ian en	易轉乾坤 逆亂乾坤
u I	絲綿掌：天蠶吐絲
an u I	絲綿掌：天蠶吐絲
ian an u I	絲綿掌：天蠶吐絲
ian ao I	撥繭挑絲
o ian ao I	撥繭挑絲
ian o ou	絲前搏後
I ian o ou	絲前搏後
in ang in	伏妖金剛印 般若神掌：金剛印 金剛印
： in ang in	般若神掌：金剛印
o in	伏魔印 天心蓮環：包藏禍芯 天殘破金 混渦渦旋勁：長生烈火渦勁 爆破勁 長生寒冰渦勁 長生訣：長生烈火勁 風火印
u o in	伏魔印
eng o in	風火印
ian in	極樂仙音 虎千斤 雷電印
ei ian in	雷電印
ei ang an	冰寒掌霹靂：六月飛霜玄
ve ei ang an	冰寒掌霹靂：六月飛霜玄
ing i i	寒冰霹靂 雷霆一擊
an ing i i	寒冰霹靂
an II	冰封三尺 冰玄勁：冰封三尺 冰魄麒麟勁：冰封三尺 千蟲萬噬 天殘射殘日 幹日 探勢 斷肢 流星趕日 浪捲勢 深淵勢 羅漢禪指 觀音亂世 雙虹貫日 鶴展翅
eng an II	冰封三尺 冰玄勁：冰封三尺 冰魄麒麟勁：冰封三尺
ing eng an II	冰封三尺 冰玄勁：冰封三尺 冰魄麒麟勁：冰封三尺
i i ou	寒冰霹靂球 混元霹靂手
ing i i ou	寒冰霹靂球
in ei	動心雷 破日金錐 神火道：掌心雷
ang in ei	神火道：掌心雷
： ang in ei	神火道：掌心雷
u i	五情無敵 大梵天震慣配合心法：梵我如一 天覆地 提證法神功：紅菩提 攻無不克戰無敵 木級 燁陽不息 物極 神火護體 紫菩提 紫菩提 聖火護體 般若神功：綠菩提 藍菩提 逍遙無極 達摩功：土級 達摩金身：土級 金菩提 銀菩提 離心獨劈 雲龍無際 風雲合招：天道無極 魔光日無極 魔光月無極 黃菩提 黑菩提
o u i	大梵天震慣配合心法：梵我如一 神火護體 聖火護體
en o u i	神火護體
ou ong ei	炙手轟雷 百獸同悲
II ou ong ei	炙手轟雷
o ong i	雷火動地
ei o ong i	雷火動地
ei ei ong	千雷歸宗
ian ei ei ong	千雷歸宗
ou ei an	鐵沙神掌：鐵牛推山
ie ou ei an	鐵沙神掌：鐵牛推山
ang en in	鐵掌分金
ie ang en in	鐵掌分金
ie i ong ang	鐵臂銅牆
a en eng	萬馬奔騰 萬馬奔騰 鐵沙焚城
ie a en eng	鐵沙焚城
ie ou	庖丁解牛 招魂鐵手 鐵沙綿掌：招魂鐵手
en ie ou	招魂鐵手 鐵沙綿掌：招魂鐵手
ao en ie ou	招魂鐵手 鐵沙綿掌：招魂鐵手
ing vn	排雲掌：流水行雲 流水行雲 長恨歌：紫氣入青雲
ei ing vn	排雲掌：流水行雲 流水行雲
ou ei ing vn	排雲掌：流水行雲 流水行雲
ai ve	披雲戴月 翻海訣
vn ai ve	披雲戴月
i vn ai ve	披雲戴月
u v	武當太極雲掌：翻雲覆雨 翻雲覆雨 雲覆雨
vn u v	武當太極雲掌：翻雲覆雨 翻雲覆雨 雲覆雨
ao ai	排山倒海 排山倒海 排山倒海
an ao ai	排山倒海 排山倒海 排山倒海
ai an ao ai	排山倒海 排山倒海 排山倒海
vn II	云云日 雲勢
vn vn II	云云日
en o	修羅絕道：青焰神腿：惡獸噬神羅 刁魂破 重雲深鎖
vn en o	重雲深鎖
ong vn en o	重雲深鎖
ai vn	戰龍在群 渾天寶鑑：白雲 翻天排雲
ian ai vn	翻天排雲
an ian ai vn	翻天排雲
vn ai o	雲海波
u ing	仙氣風峰處處處處行 南鋒無定 唐手武道：天地無情 如影附形 幻龍無影 幻龍無影 無極爪：坤無定 變云無定 野狼孤鷹
vn u ing	變云無定
ian vn u ing	變云無定
ian ang	刀劍合一：刀羅劍網 幻魔四變：變相 殃雲天降 火翼天翔 百孔千瘡 霧電象
vn ian ang	殃雲天降
ang vn ian ang	殃雲天降
ian ing	六箭碎天靈 碎天靈 雲萊仙境
ai ian ing	雲萊仙境
vn ai ian ing	雲萊仙境
ei ing	天殘尾釘 悲鳴 愁慘淡配合配合步法：雲踪魅影 無定飛星 無影無踪：如影隨形 追命十三腿：追影 霍雷霆
ong ei ing	愁慘淡配合配合步法：雲踪魅影
vn ong ei ing	愁慘淡配合配合步法：雲踪魅影
： II	混沌：勢 青綿掌：勢 鬼打邪功：魑
ang ： II	青綿掌：勢
ian ang ： II	青綿掌：勢
eng II	天禪手赤雲封日 節外生枝 霹靂神腿：追風式 風勢
II u eng	勢步城
a ：	九玄大法： 大陽法： 天地大法： 天法： 配合步法：
u a ：	配合步法：
e u a ：	配合步法：
ang ：	密宗金剛掌： 渾天神掌： 血穹蒼：
en ang ：	渾天神掌：
ian en ang ：	渾天神掌：
in i in	一心碧印
i in i in	一心碧印
vn ian	渾天邪劍：白雲劍 白雲煙 過眼雲煙
ai vn ian	渾天邪劍：白雲劍 白雲煙
a ang	九霄真經：霓霞象 四轉八方 天羅殺網 春雷乍響 瑞霞盪 瑞霞盪 硃砂掌 飛蓮踏浪
ei a ang	春雷乍響 瑞霞盪 瑞霞盪
en en	兩扇拱勢靛藍滄海：吞吞 土崑崙 土崑崙 大悲佛手：悲天刎人 泰山崩純陽級：乾坤身 陰陽混沌 魔帶：天魔分身
u en en	土崑崙 土崑崙
ve ing	絕情 雪冰
ing e	劍器：劍嘯星河 崩雪斬碧星河：星河 紫星河
I ing e	紫星河
ei o ing	五輪金剛掌：天雷破嶺 坎雷過嶺 魍魎混元勁：第七重鬼索命
ian ei o ing	五輪金剛掌：天雷破嶺
ian eng ong	殛電橫空 雷電橫空 雷電橫空
i ian eng ong	殛電橫空
an ao eng	九闕三焦生 旋轉暴風
an an ao eng	旋轉暴風
u ai ian	怒海天 盤古開天
an a ao	陽世五絕掌：陽關大道
ang an a ao	陽世五絕掌：陽關大道
ang i	七十二罡氣：一轉八罡氣 七轉五十六罡氣 三轉二十四罡氣 九轉七十二罡氣 九陽一 二轉十六罡氣 五轉四十罡氣 元陽閉 八轉六十四罡氣 六轉四十八罡氣 反兩儀 四轉三十二罡氣 正兩儀 火雷罡氣 烈陽剛氣 飛馬張翼
an ang i	元陽閉 反兩儀
i ai	三陽啟泰 九陽神功：第一陽心坎穴第二陽丹田穴第三陽足陽明胃穴第三陽足太陽經穴第五陽手小太陽經穴第六陽手少陽三焦經穴第七陽脊梁穴第八陽至陽穴第九陽百會穴：九陽啟泰 五箭傷氣海 地極氣海 氣海無涯：天極氣海 無量神掌：無量氣海 破邪三限：地脈 突如其來 突如其來
ang i ai	三陽啟泰 九陽神功：第一陽心坎穴第二陽丹田穴第三陽足陽明胃穴第三陽足太陽經穴第五陽手小太陽經穴第六陽手少陽三焦經穴第七陽脊梁穴第八陽至陽穴第九陽百會穴：九陽啟泰 五箭傷氣海 無量神掌：無量氣海
an ang i ai	三陽啟泰
in ao ang	顛陰倒陽
ian in ao ang	顛陰倒陽
ang an in	移陽轉陰
i ang an in	移陽轉陰
ong ou ei	二十三式降龍掌：亢龍有悔 亢龍有悔 等龍有悔 群龍有悔 降龍十八掌：亢龍有悔 降龍十八掌：亢龍有悔 降龍十八掌：亢龍有悔 降龍十八掌：亢龍有悔
ang ong ou ei	二十三式降龍掌：亢龍有悔 亢龍有悔 降龍十八掌：亢龍有悔 降龍十八掌：亢龍有悔 降龍十八掌：亢龍有悔 降龍十八掌：亢龍有悔
ong ai ian	見龍在田 見龍在田 見龍在田 見龍在田 見龍在田 見龍在田 見龍在田 見龍在田 見龍在田 飛龍在天 飛龍在天 飛龍在天 飛龍在天 飛龍在天 飛龍在天 龍在天
ei ong ai ian	飛龍在天 飛龍在天 飛龍在天 飛龍在天 飛龍在天 飛龍在天
ong ai ie	戰龍在野 戰龍在野 戰龍在野 戰龍在野
an ong ai ie	戰龍在野 戰龍在野 戰龍在野 戰龍在野
ong u ong	十七式降龍掌：青龍出洞 潛龍勿用 潛龍勿用 潛龍勿用 潛龍勿用 降龍十八掌：青龍出洞 降龍十八腿：青龍出洞 青龍出洞 青龍出洞 青龍出洞 青龍出洞 青龍出洞
ian ong u ong	潛龍勿用 潛龍勿用 潛龍勿用 潛龍勿用
o ai an	或在淵 烈火開山
ong ai ei	神龍擺尾 神龍擺尾 神龍擺尾 神龍擺尾 神龍擺尾 神龍擺尾 神龍擺尾 神龍擺尾 神龍擺尾 神龍擺尾 蝎子洞擺尾
en ong ai ei	神龍擺尾 神龍擺尾 神龍擺尾 神龍擺尾 神龍擺尾 神龍擺尾 神龍擺尾 神龍擺尾 神龍擺尾 神龍擺尾
ian ong ai ian	見龍在田 見龍在田 見龍在田 見龍在田 見龍在田 見龍在田 見龍在田 見龍在田 見龍在田
ong an u	乾隆亂舞 狂龍亂舞 群龍亂舞 群龍亂舞 群龍亂舞 群龍亂舞 降龍十八掌：龍亂舞 龍亂舞
vn ong an u	群龍亂舞 群龍亂舞 群龍亂舞 群龍亂舞
o ai	無邊火海 蛟龍過海 飛將奪帥 麻鷹捉仔
ong o ai	蛟龍過海
ao ong o ai	蛟龍過海
ou en ong	左右神龍 左右神龍 左右神龍 左右神龍
o ou en ong	左右神龍 左右神龍 左右神龍 左右神龍
ong ou in	黑龍偷心 黑龍偷心 黑龍偷心 黑龍偷心 黑龍偷心 黑龍偷心
ei ong ou in	黑龍偷心 黑龍偷心 黑龍偷心 黑龍偷心 黑龍偷心 黑龍偷心
e ong an	惡龍纏 惡龍纏 惡龍纏 惡龍纏 惡龍纏
er ong eng u	二龍爭珠 二龍爭珠 二龍爭珠 二龍爭珠
ing ong u ong	十七式降龍掌：青龍出洞 降龍十八掌：青龍出洞 降龍十八腿：青龍出洞 青龍出洞 青龍出洞 青龍出洞 青龍出洞 青龍出洞
ang u	奪狼命爪：獵狼兔 白龍擋路 白龍擋路 神風動：風雨江湖 蛇行蟒伏
ong ang u	白龍擋路 白龍擋路
ai ong ang u	白龍擋路 白龍擋路
ing ang ong	易經降龍 火精當空
i ing ang ong	易經降龍
ong ing a	飛龍頂壓
ei ong ing a	飛龍頂壓
ong en ao	龍伸腰
ong ai ong	火龍在空
o ong ai ong	火龍在空
i ong	五嶽齊轟雷兮天地：萬雷齊轟 劍洗千里空 四炁歸宗萬劫一空 滾地龍 滾地龍 滾地龍 滾地龍 血霧迷踪 電劍殛空 霹靂震空問電式：殛空
en i ong	滾地龍 滾地龍 滾地龍 滾地龍
ai ou ian	降龍十八腿：龍在九天 降龍十八腿：龍在九天 龍在九天 龍在九天 龍在九天 龍在九天 龍在九天
ong ai ou ian	降龍十八腿：龍在九天 降龍十八腿：龍在九天 龍在九天 龍在九天 龍在九天 龍在九天 龍在九天
eng en	一念成仁 冰玄成盾 冰玄成盾 天殘大風輪 天殘腿：天小風輪 縮龍成寸 縮龍成寸 縮龍成寸 縮龍成寸 縮龍成寸 霹靂玄功：霹靂猛震
ong eng en	縮龍成寸 縮龍成寸 縮龍成寸 縮龍成寸 縮龍成寸
o ong eng en	縮龍成寸 縮龍成寸 縮龍成寸 縮龍成寸 縮龍成寸
ong u ing	幻龍無影 幻龍無影
an ong u ing	幻龍無影 幻龍無影
ie ong ian	鐵龍剪 鐵龍剪
ong o ing	雲龍破嶺 雲龍破嶺
vn ong o ing	雲龍破嶺 雲龍破嶺
ong an ang	蛟龍翻江 蟠龍翻江 蟠龍翻江
an ong an ang	蟠龍翻江 蟠龍翻江
ian ong o	天龍鎖 天龍鎖 天龍鎖 天龍鎖
an eng	龍捲風 龍捲風 龍捲風 龍捲風
ong an eng	龍捲風 龍捲風 龍捲風 龍捲風
e ong eng u	餓龍爭珠 餓龍爭珠
ou ong i ei	遊龍戲水 遊龍戲水
u ong an	毒龍鑽 毒龍鑽 箭腿毒龍鑽 電光毒龍鑽 電光毒龍鑽 電光毒龍鑽
u i ai	突如其來 突如其來
u u i ai	突如其來 突如其來
v ei	雙龍取水 龍取水
ong v ei	雙龍取水 龍取水
en ong ei	神龍尾
e a an	利涉大川 利涉大川 龍涉大川
i e a an	利涉大川 利涉大川
ian v u	鴻漸於陸 鴻漸於陸 鴻漸於陸
ong ian v u	鴻漸於陸 鴻漸於陸 鴻漸於陸
u ian i	焦土千里 狂龍亂舞天地 虎千霹
an u ian i	狂龍亂舞天地
ao ong ang	蛟龍江
ing II	夜鷹勢 履霜冰至 履霜冰至 惡鬼凌遲 深惡痛絕罪凌遲 白虹掌力：白虹貫驚日 虎口凌遲 邪血凌遲 閃電四式：幻影式 霜冰至
ang ing II	履霜冰至 履霜冰至 霜冰至
ou ong	影遊踪 時乘六龍 時乘六龍 銅蹄踏雪銅頭：銅頭功
eng ou ong	時乘六龍 時乘六龍
II eng ou ong	時乘六龍 時乘六龍
eng u ve	龍遊勝五嶽
ou eng u ve	龍遊勝五嶽
ou ong u	神龍降世配合步法：遊龍步
： ou ong u	神龍降世配合步法：遊龍步
ve v an	魚躍於淵 龍躍於淵
ong ve v an	龍躍於淵
ong ang ei	盤龍雙飛 蟠龍雙飛 蟠龍雙飛 蟠龍雙飛
an ong ang ei	盤龍雙飛 蟠龍雙飛 蟠龍雙飛 蟠龍雙飛
ong an ian	龍纏綿
ong in an	蛟龍臨淵
ao ong in an	蛟龍臨淵
ang ong ang	八方龍王
a ang ong ang	八方龍王
e ong en II	惡龍吞日
ong ai vn	戰龍在群
an ong ai vn	戰龍在群
ong in	刀槍不入龍鱗 力不從心 澤里龍吟 烈火攻心 煮鐵融金 獸神訣：野豹衝林
i ong in	澤里龍吟
e i ong in	澤里龍吟
ve ai an	或躍在淵 或躍在淵 或躍在淵 或躍在淵 龍躍在淵
ong ve ai an	龍躍在淵
ong e a an	龍涉大川
ong an i	龍萬里
ong u ou	群龍無首 龍無首
ong u i	提證法神功：紅菩提 雲龍無際
vn ong u i	雲龍無際
II an an	五行八卦掌：終日干幹 終日干幹 終日干幹 終日干幹 終日干幹
ong II an an	五行八卦掌：終日干幹 終日干幹 終日干幹 終日干幹 終日干幹
ian i e	雷電覓嗑
ei ian i e	雷電覓嗑
v ang ing II	履霜冰至 履霜冰至
o ve ai an	或躍在淵 或躍在淵 或躍在淵 或躍在淵
v ie	十方俱俱滅 神俱滅 降龍神腿：龍戰於野 龍戰於野
an v ie	降龍神腿：龍戰於野 龍戰於野
ong an v ie	降龍神腿：龍戰於野 龍戰於野
ian ong u	潛龍勿
ai i	驚百里
ing ai i	驚百里
ve u an	或躍入淵
o ve u an	或躍入淵
ang ong v ei	雙龍取水
u vn	密雨不云
v u vn	密雨不云
i v u vn	密雨不云
ou u	損則有孚 羅漢叩佛 西天求渡
e ou u	損則有孚
en e ou u	損則有孚
ang u an	天網復原 烈陽毒拳 羝羊觸藩
i ang u an	羝羊觸藩
v ve v an	魚躍於淵
ong II II	盤龍蝕日
an ong II II	盤龍蝕日
an i an	龍捲氣旋
ong an i an	龍捲氣旋
a i	殺器 殺器 釋法義 陰陽大移 龍震大地
en a i	龍震大地
ong en a i	龍震大地
vn ong u ou	群龍無首
vn an i	火雲萬里 龍群萬里
ong vn an i	龍群萬里
ong a ian i	龍跨千里
in ong	五爪金龍 八方擒龍 密宗龍爪手：金剛擒龍 盤古真武訣：末日隱空 鐵骨奇功：鐵手擒龍 雷電門三大絕招：電網擒龍
ang in ong	八方擒龍 密宗龍爪手：金剛擒龍 雷電門三大絕招：電網擒龍
a ang in ong	八方擒龍
ao ong an ang	蛟龍翻江
ong ian ei	神龍剪水 轟天雷 雙龍剪水 雙龍剪水
en ong ian ei	神龍剪水
an ai ie	龍戰在野
ong an ai ie	龍戰在野
eng ong ou ei	等龍有悔
o ong u u	火龍吐珠 火龍吐珠
： ong an u	降龍十八掌：龍亂舞
vn ong ou ei	群龍有悔
eng ou	天蠍腿：毒蠍封喉 頸封喉 鷹爪封喉 黯然銷掌：無中生有
ong eng ou	黯然銷掌：無中生有
u ong eng ou	黯然銷掌：無中生有
II i ing	孤只泥影 日月神鑑：陰世奇經 陽世奇經
u II i ing	孤只泥影
en e	面無人色
u en e	面無人色
ian u en e	面無人色
u ei ei	想入非非
ang u ei ei	想入非非
ai u	幽魂幽魂徘徊谷 無常開路 神通彈道：十面埋伏 鋒寒式：塞外戈狼煙四起土埋骨
ai ai u	幽魂幽魂徘徊谷
en ai ai u	幽魂幽魂徘徊谷
in ing ou ao	心驚肉跳
i en ou ian	杞人憂天
o ai ei	拖帶水
u ong in	刀槍不入龍鱗 力不從心
i u ong in	力不從心
II ou ou	屍走肉
u o u	窮途末路
ong u o u	窮途末路
i II	代以擊石 倒行​​逆施 動地式 碎天絕手：完美一式 虹牆蔽日 蠍尾腿：倒柳逆施 靈犀一指 靈犀一指
​ i II	倒行​​逆施
ing ​ i II	倒行​​逆施
I ao	庸人自擾
en I ao	庸人自擾
ong en I ao	庸人自擾
o II en	廢寢食若失恨 食若失恨
II o II en	廢寢食若失恨 食若失恨
u e	上地至尊功：天罡氣訣之五行互克 殺無赦 水雲訣：泥船渡河 神不捨 神不捨
en u e	神不捨 神不捨
e eng	不守舍聲 不守舍聲 舍生
ou e eng	不守舍聲 不守舍聲
u ou e eng	不守舍聲 不守舍聲
an v	銷魂掌法：緣來緣去
ai an v	銷魂掌法：緣來緣去
an ai an v	銷魂掌法：緣來緣去
ao i e	天造地設
ian ao i e	天造地設
ing ang ei	蝶影雙飛
ie ing ang ei	蝶影雙飛
ing ie ang	有影皆雙
ou ing ie ang	有影皆雙
vn ong	三“十”掌：雷霆雲湧
ing vn ong	三“十”掌：雷霆雲湧
ei ing vn ong	三“十”掌：雷霆雲湧
o u ian	風火無邊
eng o u ian	風火無邊
ing u i	五情無敵
u ing u i	五情無敵
u a	化作春泥更護花 穹蒼無涯 血海無涯 銀月無華 雙手掌：苦海無涯 骷髏魔骷甲
ai u a	血海無涯 雙手掌：苦海無涯
u ai u a	雙手掌：苦海無涯
u ong eng	普渡眾生 普渡眾生 百毒縱橫
u u ong eng	普渡眾生 普渡眾生
ou ang e	當頭棒喝
ang ou ang e	當頭棒喝
u en	五內如焚 唯我獨尊 明鏡拂塵 逆陽神鑑：五內如焚 魔無神
ing u en	明鏡拂塵
ing ing u en	明鏡拂塵
a ie ong	四大皆空
I a ie ong	四大皆空
u en ong	暮鼓晨鐘
u u en ong	暮鼓晨鐘
i u u u	七級浮屠屠
u ang i ai	無量神掌：無量氣海
ao u ang	狂濤無量 驚濤無量
ang ao u ang	狂濤無量
ong u ang	狂龍無量
ang ong u ang	狂龍無量
ai u ang	大海無量
a ai u ang	大海無量
ing ao u ang	驚濤無量
i en	無量殛震 酩酊心法七重：醉一分——大醉七分 雷霆殛震
ang i en	無量殛震
u ang i en	無量殛震
II ao	無量直搗 破頭蝕腦 碎石腳
ang II ao	無量直搗
u ang II ao	無量直搗
ang a ian	海網撒天
ai ang a ian	海網撒天
an ai an	千漩百轉
ian an ai an	千漩百轉
ang ang an	海量汪涵 狂狼斬
ai ang ang an	海量汪涵
ie i	佛心轉世業力 大天魔場：天魔解體 天魔裂地 水銀瀉地 無殛電：電網瀉地 無量追踪疊起 發電傷人階梯 虹光瀉地 解金剛解肌 閃電奇功：蓄電護體階梯 霸王神功：無環裂地
ong ie i	無量追踪疊起
ei ong ie i	無量追踪疊起
ao a a	浪濤沙沙
ang ao a a	浪濤沙沙
ai en	邪風掌法：鬼王拍門 鐵拐李旋肘膝撞醉還真 陰司魅手：雙鬼拍門 陰風爪：陰差拍門
ang ai en	邪風掌法：鬼王拍門
ei ang ai en	邪風掌法：鬼王拍門
o an u	天魔亂舞 邪魔亂舞
ie o an u	邪魔亂舞
ong ai	如意禪：佛我同在 工白 紫氣東來
o ong ai	如意禪：佛我同在
u o ong ai	如意禪：佛我同在
ei II	一念以貫之功：——以念聚意，悉意之所釋，一以氣神以貫之，以氣神以貫之，不能。一念以沛之，一剎神之貫之以十里，驚驚雷之 冰火碎屍 混元七殛：破雷勢 百鬼碎屍 萬法唯識 血火邪罡：火龍追日 追日 追逝
a ei II	萬法唯識
an a ei II	萬法唯識
v ong	割碎虛空 大日虛空 拳碎虛空 聚龍
II v ong	大日虛空
a II v ong	大日虛空
ang ei i	十陽歸一 無量為一
u ang ei i	無量為一
an en	亂魂 六道戰神 冤鬼纏身 分屍散魂 千雷萬震 如意禪震 梵我不二大法：小梵天禪震
i an en	如意禪震
u i an en	如意禪震
an ing II	白虹掌力：白虹貫驚日 閃電四式：幻影式
ong an ing II	白虹掌力：白虹貫驚日
ong en ian	火虹焚天 火龍吞天 火龍吞天
o ong en ian	火虹焚天 火龍吞天 火龍吞天
ong an ou	虹斷流
ang i II	虹牆蔽日
ong ang i II	虹牆蔽日
ang ie i	無殛電：電網瀉地 虹光瀉地 解金剛解肌
ong ang ie i	虹光瀉地
ong u ian	冰火五重天：火龍初現 冰火五重天：火龍初現 采虹補天
ai ong u ian	采虹補天
ian an vn	日焰卷雲 火箭穿雲 金劍穿雲
II ian an vn	日焰卷雲
ong ai II	火龍拜日
o ong ai II	火龍拜日
ang u i	燁陽不息 黃菩提
ie ang u i	燁陽不息
o vn an i	火雲萬里
ang i i	烈陽霹靂 陰陽兩極氣 雪糖霹靂
ie ang i i	烈陽霹靂
ou o	修羅 冥府修羅 銀月掌：月營流梭
ing ou o	銀月掌：月營流梭
ve ing ou o	銀月掌：月營流梭
an ing	七箭截脈手：一箭化三清 兇暴亂影 月魂幻影 移形換影 觀音亂：觀音亂影
en an ing	月魂幻影
ve en an ing	月魂幻影
u an an	銀弧斷斷
in u an an	銀弧斷斷
ve ao ao	怒月暴潮
u ve ao ao	怒月暴潮
ve o	星凝月落
ing ve o	星凝月落
ing ing ve o	星凝月落
a II II	白華蝕日
ai a II II	白華蝕日
ve u a	銀月無華
in ve u a	銀月無華
o ：	天羅天羅：
ian o ：	天羅天羅：
o ian o ：	天羅天羅：
ang ang o	左天羅降降羅
o ang ang o	左天羅降降羅
o ian o	天羅天羅
ian o ian o	天羅天羅
ou ei o	右地網：天修墜落
ian ou ei o	右地網：天修墜落
ang an ian	地網翻天 狼斬天
i ang an ian	地網翻天
ie ang II	結網勢
ei ang II	回網勢
ian an ang	天羅天萬網
o ian an ang	天羅天萬網
II ：	雷撒網電勢：
ian II ：	雷撒網電勢：
ang ian II ：	雷撒網電勢：
i ang ao	兩儀八卦掌：綿里藏刀 火裡藏刀
ian i ang ao	兩儀八卦掌：綿里藏刀
ai ai	八卦掌：否極泰來 否極泰來
i ai ai	八卦掌：否極泰來 否極泰來
ou i ai ai	八卦掌：否極泰來 否極泰來
eng ang i	正兩儀
ang ang i i	陰陽兩極氣
ing ian	冰柱擎天 四靈劍 天行健 離火七煞掌：一火擎天 青焰
o ing ian	離火七煞掌：一火擎天
i o ing ian	離火七煞掌：一火擎天
o i ang ao	火裡藏刀
o ei	兄弟離火碎 吸裂精奪髓 天魔錐
i o ei	兄弟離火碎
i i o ei	兄弟離火碎
v en	五臟俱焚 寒冰獄魂 玉石俱焚 香銷玉損
ang v en	五臟俱焚
u ang v en	五臟俱焚
eng ei	六神成灰 日月爭輝 血肉橫飛
en eng ei	六神成灰
ou en eng ei	六神成灰
en an ian	千焚萬煉
ian en an ian	千焚萬煉
e ian	大澤劍 少澤劍 少澤劍 星河劍 毒蠍車鞭 隻手遮天
ou e ian	隻手遮天
II ou e ian	隻手遮天
an ei o ing	坎雷過嶺
ou eng an	左右逢源
o ou eng an	左右逢源
an ang a	卦玄擋煞
a an ang a	卦玄擋煞
ve II	天殘掌法：天殘缺日 天鷹攫日
an ve II	天殘掌法：天殘缺日
ian an ve II	天殘掌法：天殘缺日
ve ve	天殘缺月 明月訣 明月訣
an ve ve	天殘缺月
ian an ve ve	天殘缺月
an II II	天殘蝕日
ian an II II	天殘蝕日
ve ian an	日月天殘
II ve ian an	日月天殘
ao eng vn	地缺掌法：蛟騰雲
： ao eng vn	地缺掌法：蛟騰雲
e a u	蛇打霧 蛇打霧
ao u ian	豹逐電
ou e	三轉六合 人煞掌法：神不守舍 將軍抽車 蛇步遊蛇
u ou e	人煞掌法：神不守舍 蛇步遊蛇
en u ou e	人煞掌法：神不守舍
in v ve	傷心欲絕
ang in v ve	傷心欲絕
o u ang	搜索枯腸
ou o u ang	搜索枯腸
ian ian	明玉綿掌：意綿綿 烽火連天 花火煉：焮天焰 風雨蓮天
i ian ian	明玉綿掌：意綿綿
： i ian ian	明玉綿掌：意綿綿
ai ie eng	氣歪邪風
i ai ie eng	氣歪邪風
e ang	冰河莽 無邪掌：風可長
eng e ang	無邪掌：風可長
： eng e ang	無邪掌：風可長
ie ai	六業衰 否極邪來
i ie ai	否極邪來
ou i ie ai	否極邪來
ang en ou	迷竅毒掌：斷腸溫柔
an ang en ou	迷竅毒掌：斷腸溫柔
in en i	痴心魂離 長生訣：先天純陰真氣
II in en i	痴心魂離
i eng	和氏璧異能 和氏璧異能 和氏璧異能 和氏璧異能 和氏璧能 太極封 盪魄綺夢
o i eng	盪魄綺夢
ang o i eng	盪魄綺夢
ong in u	蝕骨春宵配合毒功：陰陽毒功陰毒
u ong in u	蝕骨春宵配合毒功：陰陽毒功陰毒
ian en a	千毒掌：風起雲湧毒鎖千峰配合毒縷：千毒絕心經配合身法：一輕煙身法
ing ian en a	千毒掌：風起雲湧毒鎖千峰配合毒縷：千毒絕心經配合身法：一輕煙身法
an vn u v	武當太極雲掌：翻雲覆雨 翻雲覆雨
an vn ai ing	穿雲摘星
a a u	雲游太虛配合步法：八卦步
： a a u	雲游太虛配合步法：八卦步
in ian a	至尊功：開山劈石：上天下地：排山倒海：千軍萬馬：君臨天下 赤煞掌：鷹臨天下
ing in ian a	赤煞掌：鷹臨天下
ing ing	怒鷹鷹
u ing ing	怒鷹鷹
ing u u	雄鷹撲兔 餓鷹撲兔
e ing u u	餓鷹撲兔
ing o II	殘鷹落日 神鷹破日 群鷹奪食
vn ing o II	群鷹奪食
ou vn	形影流雲 掌心電：電流雲
ian ou vn	掌心電：電流雲
： ian ou vn	掌心電：電流雲
ang in ian	掌心電
ian ong ve	逍遙掌：雙仙拱月
ang ian ong ve	逍遙掌：雙仙拱月
ing ong	天馬神腿：天馬行空 幽冥空 無影鷹踪 玄冰功 翻天覆地絕人寰配合身肺法：無影鷹踪 逆浪行凶 閃電掌：疾電驚虹 雙蠍行空 雷霆轟
ian ing ong	閃電掌：疾電驚虹
i ian ing ong	閃電掌：疾電驚虹
i en en ou	金絲掌：黃天當立震神州
ong an vn	劈空掌法：裂空斷雲
ie ong an vn	劈空掌法：裂空斷雲
in u i	金菩提 銀菩提 離心獨劈
i in u i	離心獨劈
I an ou	陰綿綿掌：絲絲玄扣
I I an ou	陰綿綿掌：絲絲玄扣
i ei an	澤地歸元 紫氣歸元 蕩氣迴旋
ang i ei an	蕩氣迴旋
ang ang	冰河莽莽 天罡掌 彌勒降殃 星火相撞 獸穴法＆爪：鬼影幢幢 第十八式青龍掌掌掌 純陽掌 血神經：血氣方剛
ian ang ang	天罡掌
u o	力貫萬象步墮 少林金剛掌：伏妖除魔 無恨無我
ao u o	少林金剛掌：伏妖除魔
u ao u o	少林金剛掌：伏妖除魔
ang a an	橫掃千軍象拔拳 金剛下凡
in ang a an	金剛下凡
ong an ong	百毒千手掌：毒蟲鑽洞
u ong an ong	百毒千手掌：毒蟲鑽洞
ong an II	千蟲萬噬 雙虹貫日
ian ong an II	千蟲萬噬
o ang	獄火掌 興風作浪 金鱗破浪 霍象
v o ang	獄火掌
： ei ian	紫電天羅：雷電
o ： ei ian	紫電天羅：雷電
o an ang	紫電千電羅萬網
ian o an ang	紫電千電羅萬網
u a ang	硃砂掌
ian en ang	易天乾坤掌
ian ian en ang	易天乾坤掌
in ：	九字真言手印： 奇門閻羅勁： 截拳勁：
ou in ：	九字真言手印：
ian ou in ：	九字真言手印：
in ou	大金剛輪印鬥
en in ou	大金剛輪印鬥
ang en in ou	大金剛輪印鬥
in e	外獅子印者
I in e	外獅子印者
II I in e	外獅子印者
in ie	內獅子印皆 撕心裂
I in ie	內獅子印皆 撕心裂
II I in ie	內獅子印皆
in en	外縛印陣 大禍臨門 天魔五絕：天魔金身 無常爪：無常擒魂 童子金身 達摩金身 閻羅陰神
u in en	外縛印陣
ai u in en	外縛印陣
ei u in	九陰寒屍功：碎骨勁 內縛印
II en in ian	日輪印前
in e i	寶瓶印合招：真言九印合一
ou in e i	寶瓶印合招：真言九印合一
ing ai an	推山手：五丁開山
u ing ai an	推山手：五丁開山
ong i an	共工移川 愚公移山
v ong i an	愚公移山
in eng u	殺心雷：殺心成佛
a in eng u	殺心雷：殺心成佛
in ao	佛動心搖 左右金橋 心爪 風中勁草
ong in ao	佛動心搖 風中勁草
u ong in ao	佛動心搖
i I ian	殺地撕天
a i I ian	殺地撕天
vn eng II	天禪手赤雲封日
II vn eng II	天禪手赤雲封日
ang i ie	火網提鱉
o ang i ie	火網提鱉
o an ou	烈火斷頭
ie o an ou	烈火斷頭
v en ian i	拒人千里
ian ang u an	天網復原
ao o	挑撥 百足無影手：巧取豪奪 神龍爪誅妖魔 藍忘機采和單提敬酒攔腰破
v ao o	百足無影手：巧取豪奪
ao v ao o	百足無影手：巧取豪奪
o ao II	本末倒置
en o ao II	本末倒置
ai vn ai ing	排雲摘星
ian u i	天覆地
II e	探花截脈手：望梅止渴
ei II e	探花截脈手：望梅止渴
ang ei II e	探花截脈手：望梅止渴
eng ian en	聞風先遁
en eng ian en	聞風先遁
v ang	問於盲 雨象
en v ang	問於盲
ie ou i i	切肉離皮
a ing en	如來千佛手：轉法經輪 如來大手印：轉法經輪
an a ing en	如來千佛手：轉法經輪 如來大手印：轉法經輪
ian eng	佛點千燈 奈何橋上身忘前生
ian ian eng	佛點千燈
u ian ian eng	佛點千燈
ang ao II	佛光耀世
o ang ao II	佛光耀世
a eng u	萬家生佛
an a eng u	萬家生佛
o ang eng	乾坤轉業雙明：因果相承
in o ang eng	乾坤轉業雙明：因果相承
i an ie	緣起緣滅
an i an ie	緣起緣滅
II ie i	佛心轉世業力
an II ie i	佛心轉世業力
u an ve	五絕殺神手：折骨斷絕 靈蛇七絕：毒探穴
e u an ve	五絕殺神手：折骨斷絕
in a ve	驅盡殺絕
v in a ve	驅盡殺絕
e ong ve	心惡痛絕
in e ong ve	心惡痛絕
ang ao ie	神亡消滅
en ang ao ie	神亡消滅
an an ve	人寰慘絕
en an an ve	人寰慘絕
ou ian an	魔鬼四絕手：慘絕人寰扣連環
an ou ian an	魔鬼四絕手：慘絕人寰扣連環
eng i	熱沙聲七 絕子絕孫絕生機
ve eng i	絕子絕孫絕生機
en ve eng i	絕子絕孫絕生機
ei ing II	惡鬼凌遲 深惡痛絕罪凌遲
ve ei ing II	深惡痛絕罪凌遲
II ang	冰封十丈 冰封十丈 器絕十方 絕天絕地絕十方 雪寶石像
ve II ang	器絕十方 絕天絕地絕十方
i ve II ang	器絕十方 絕天絕地絕十方
a o an	斷筋破骨大劈手：怒打羅漢
u a o an	斷筋破骨大劈手：怒打羅漢
ai in	如來心 無常采心
u ai in	如來心
an u ian	九轉珠連
ou an u ian	九轉珠連
ei ang ang	彌勒降殃
i ei ang ang	彌勒降殃
an o II	破空元手：破元手：破雷殛震空元手：空元破日
ong an o II	破空元手：破元手：破雷殛震空元手：空元破日
ong u ie	空空如也
ong ong u ie	空空如也
ai II ve	空懷日月
ong ai II ve	空懷日月
o ve	二雷破岳 五雷破岳 沉元破月 紫旋破岳 飛虎虎破岳
an o ve	沉元破月 紫旋破岳
en an o ve	沉元破月
o ong	沉空破空 百變擒龍手：鐵索鎖龍 螢火轟 鐵拳破空 離火玄冰功：離火功
ong o ong	沉空破空
en ong o ong	沉空破空
o ei II	冰火碎屍 混元七殛：破雷勢
： o ei II	混元七殛：破雷勢
an ang II	八步穿陽指 翻江勢 貪狼日
ong in ei	動心雷
i ian II	疾電勢 疾電式
ian en i	天魂殛
ou in ao	左右金橋
o ou in ao	左右金橋
ian ong an u	乾隆亂舞
ao vn	橋運
ang an vn	鐵橋八形：龍翔翻雲
ong ang an vn	鐵橋八形：龍翔翻雲
eng ve	正一純陽功：旭陽級：乘風訣 皇極驚天訣：焚城訣 豹縱橫躍
ong eng ve	豹縱橫躍
ao ong eng ve	豹縱橫躍
e an II	天殘射殘日 鶴展翅
u u II	撲撲噬
en ve	坤月 猿震嶽
an en ve	猿震嶽
u ei	怒毀 有巢築壘 煉鐵手之斷煉鐵手五訣：狂土雷 穹蒼無悔 逆天無悔 魂魂：二式玄武悲
ang u ei	煉鐵手之斷煉鐵手五訣：狂土雷 穹蒼無悔
： ang u ei	煉鐵手之斷煉鐵手五訣：狂土雷
o en ian	炎陽奇功：太火焚天 禦火吞天 血火沉天 達摩神劍
v o en ian	禦火吞天
ie ei ong ian	滅水空焰
u an ang	哭斷腸 百步穿揚 絕木幹罡
ve u an ang	絕木幹罡
in an ve	化金元訣
a in an ve	化金元訣
an ao ie	石黑龍自創道：追魂五十滾攔腰劫
en an ao ie	石黑龍自創道：追魂五十滾攔腰劫
i ei ong ian	一飛沖天
o en ang	落魂樁 達摩三絕：達摩神掌
en an vn	聖心訣：萬仞穿雲 聖心訣：萬刃穿雲
an en an vn	聖心訣：萬仞穿雲 聖心訣：萬刃穿雲
ian ang ei	帝天狂雷 帝天狂雷
i ian ang ei	帝天狂雷 帝天狂雷
u en ei	魔佛佛輪迴
u u en ei	魔佛佛輪迴
ve ang in	魔佛血狂臨
u ve ang in	魔佛血狂臨
o ao	修羅道 刻骨銘心爪：刻骨銘心爪：破腦 唯我道 大天魔刀 天魔刀：小天魔刀 破腦 破腦 裂頭破腦 轉心魔道
in o ao	轉心魔道
an in o ao	轉心魔道
o u ong	魔渡眾
ang II in	魔佛降世心 黃石金
u ang II in	魔佛降世心
ou ai	餓鬼投胎 魔問天手來
ian ou ai	魔問天手來
en ian ou ai	魔問天手來
ian en en	大悲佛手：悲天刎人 泰山崩純陽級：乾坤身
ei ian en en	大悲佛手：悲天刎人
ei u an ian	淚佛觀天
u ang o	巨佛降魔
v u ang o	巨佛降魔
a an ing	七箭截脈手：一箭化三清
ian a an ing	七箭截脈手：一箭化三清
i ong ian	雙箭擊通天
ian i ong ian	雙箭擊通天
an an i	三箭斷璇璣
ian an an i	三箭斷璇璣
o v an	四箭破巨關
ian o v an	四箭破巨關
ian ang i ai	五箭傷氣海
ei ian ing	六箭碎天靈 碎天靈
ian ei ian ing	六箭碎天靈
ei ong i	七箭碎中極
ian ei ong i	七箭碎中極
o o	分金奪魄 白骨陰風爪：噬魂奪魄 神鷹八段錦爪法：神鷹奪魄
in o o	分金奪魄
en in o o	分金奪魄
ian u ve	底無堅不決
u ian u ve	底無堅不決
u ou in	釜抽薪
ie ie	斬釘截鐵
ing ie ie	斬釘截鐵
an ing ie ie	斬釘截鐵
ei ong u	碎金斷玉配合輕功：飛縱術
： ei ong u	碎金斷玉配合輕功：飛縱術
vn i i	裂魔霹靂手：群辟易
： vn i i	裂魔霹靂手：群辟易
ai eng	十級颱風 盪夷歪風
i ai eng	十級颱風 盪夷歪風
ang i ai eng	盪夷歪風
o ie	氣破界 觀音火劫 轟天破邪 鬼火劫神火劫
ian o ie	轟天破邪
ong ian o ie	轟天破邪
eng an vn	大風雲手：破風斷雲 風捲雲
o eng an vn	大風雲手：破風斷雲
eng an an vn	風捲殘雲 風捲殘雲 風捲殘雲 風捲殘雲
o eng	崩雲破風 破夢
vn o eng	崩雲破風
eng vn o eng	崩雲破風
v eng	排雲馭風
vn v eng	排雲馭風
ai vn v eng	排雲馭風
vn i ei	風雲際會
eng vn i ei	風雲際會
e an ve	蛇形刁手：靈蛇探穴
ing e an ve	蛇形刁手：靈蛇探穴
u e u in	毒蛇吐信
ei i II	碎天絕手：完美一式
an ei i II	碎天絕手：完美一式
o ong eng	大慈咒圈：憐我眾生
ian o ong eng	大慈咒圈：憐我眾生
o o ong	百變擒龍手：鐵索鎖龍
ie o o ong	百變擒龍手：鐵索鎖龍
ie vn ai ing	七路翻雲手：裂雲摘星
ian ve	刀淵劍岳 刀霸劍絕 寒天絕 撥雲見月 翻天月 驚天訣
vn ian ve	撥雲見月
o vn ian ve	撥雲見月
ie ian ei	五雷化殛手：五滅天雷 滅天雷
u ie ian ei	五雷化殛手：五滅天雷
u ang ei	五怒狂雷
u u ang ei	五怒狂雷
： u an ve	靈蛇七絕：毒探穴
e u ou e	蛇步遊蛇
e u ong	毒蛇出洞
u e u ong	毒蛇出洞
u ：	伏羲問天錄： 散手八撲：
a u ：	散手八撲：
ou a u ：	散手八撲：
： ian o an	心錐：炎火鑽
ing an	流星貫 混元無極道：精關 破冰鑽 紫焰七勢：神鷹版
o ing an	破冰鑽
an i i ou	混元霹靂手
en ou ou	唐屍三百手：屍走尋魂颼手 裂分九州 雷動山河震九州
vn en ou ou	唐屍三百手：屍走尋魂颼手
ve ou	烈元絕手
an ve ou	烈元絕手
ie an ve ou	烈元絕手
ve ou in	血手印
ong ei in	空歸印
a ou in	如來大手印
ai a ou in	如來大手印
ei ian ou in	大黑天手印
ei ai en	鐵拐李旋肘膝撞醉還真 陰司魅手：雙鬼拍門
ang ei ai en	鐵拐李旋肘膝撞醉還真 陰司魅手：雙鬼拍門
vn an	兩極循環 天道循環 煙消雲散 青雲轉
ao vn an	天道循環 煙消雲散
ian ao vn an	天道循環 煙消雲散
ing ei u	追魂鬼手配合步法：魅影鬼步
ei ing ei u	追魂鬼手配合步法：魅影鬼步
eng in	盤絲手：一網成擒
ang eng in	盤絲手：一網成擒
i ang eng in	盤絲手：一網成擒
in a ou	拈衣擒拿手
i in a ou	拈衣擒拿手
e ing ou	惡毒蛇靈手
u e ing ou	惡毒蛇靈手
an u ou	千株萬毒手
u an u ou	千株萬毒手
I ou	百蜘蛛纏絲手
an I ou	百蜘蛛纏絲手
u an I ou	百蜘蛛纏絲手
an ong en	白骨指：血染紅塵
ve an ong en	白骨指：血染紅塵
o in en	大禍臨門 天魔五絕：天魔金身 達摩金身 閻羅陰神
a o in en	大禍臨門 達摩金身
u o II	千夫所指
ian u o II	千夫所指
ie an ao	五毒邪元爪 萬劫難逃
an ie an ao	萬劫難逃
ie v	三分神指：斷金切玉
in ie v	三分神指：斷金切玉
an in ie v	三分神指：斷金切玉
an o i	十萬火急
II an o i	十萬火急
en ian a	三分天下
an en ian a	三分天下
ei v an	櫺豫金指：櫺霏玉嬋
ing ei v an	櫺豫金指：櫺霏玉嬋
ing u ve	蓉莛暮雪
ong ing u ve	蓉莛暮雪
ing ang ve	豫嫇望月
v ing ang ve	豫嫇望月
ian a an	雪花仙指：天仙下凡
ian ian a an	雪花仙指：天仙下凡
en II u	仙人指路 勾魂蝕骨
ian en II u	仙人指路
v an a	仙女散花
ian v an a	仙女散花
ai ei ian	天外飛仙
ian ai ei ian	天外飛仙
ao ang ian	九陽神劍：少陽劍 六脈神劍：少商劍 少商劍 少陽劍
： ao ang ian	九陽神劍：少陽劍 六脈神劍：少商劍
ang ang ian	商陽劍
an ong ian	關衝劍
ao ong ian	少衝劍 少衝劍
ao e ian	少澤劍 少澤劍
a ong ian	大衝劍
a e ian	大澤劍
ing ong o II	雙陽劍：驚虹破日
： ai vn ian	渾天邪劍：白雲劍
en en ian	崑崙劍 混沌劍
i ve ian	碧雪劍
ing e ian	星河劍
ian ei an	印度海劍合招：七劍歸元 萬劍歸元
i ian ei an	印度海劍合招：七劍歸元
u u ang	達摩禪劍：一菩渡江
i u u ang	達摩禪劍：一菩渡江
an ou u	羅漢叩佛
o an ou u	羅漢叩佛
ian ai u	神通彈道：十面埋伏
II ian ai u	神通彈道：十面埋伏
o a ang	天羅殺網
ian o a ang	天羅殺網
ie ing	凶獸魔功：滅性 旱雷滅頂 牙刃血指：血光滅頂 羅漢卸兵 菩薩滅：菩薩滅頂
ei ie ing	旱雷滅頂
an ei ie ing	旱雷滅頂
an en ong	彈指神通：貫神通 彈神通 旋神通
： an en ong	彈指神通：貫神通
： an ian	金剛一指：禪箭
II ： an ian	金剛一指：禪箭
o e	冰火螳螳：螳臂破車 天機莫測 暗黑之神魔般若 神魔合
i o e	冰火螳螳：螳臂破車 天機莫測
ang i o e	冰火螳螳：螳臂破車
ang en in an	螳問心圈
a i ing	刁打七星
ao a i ing	刁打七星
ao in	崩步撩陰 毒蠍撩陰 爪勁 鷹穿爪心
u ao in	崩步撩陰
eng u ao in	崩步撩陰
ao an ou	鐮刀斷頭
ian ao an ou	鐮刀斷頭
ang e e	火螳割禾
o ang e e	火螳割禾
ing o ei II	冰火碎屍
ong ei II	血火邪罡：火龍追日
o ong ei II	血火邪罡：火龍追日
o ei ong	血火雷動
ve o ei ong	血火雷動
an ian II	純陰玄天指 陰陽指：純陽幹天指
ang an ian II	陰陽指：純陽幹天指
in an ian II	純陰玄天指
ing ian en	太玄神指：指定乾坤 雷霆電震
II ing ian en	太玄神指：指定乾坤
ian i o e	天機莫測
eng ao ang	雙鳳朝凰
ang eng ao ang	雙鳳朝凰
e ong ian an	合縱連環
ong i ian	驚虹一現
ing ong i ian	驚虹一現
ei ang i	火雷罡氣
o ei ang i	火雷罡氣
ing an ve	飛星趕月
ei ing an ve	飛星趕月
ang ong an II	雙虹貫日
ong ian ang	百孔千瘡
ai ong ian ang	百孔千瘡
II an	般若梵天指：回頭是岸
ou II an	般若梵天指：回頭是岸
ei ou II an	般若梵天指：回頭是岸
i u	毒爪擒龍配合毒功：腐肌蝕骨奇毒 毒蜂指：鋒芒畢露 雨芭打蕉鳳棲梧
ang i u	毒蜂指：鋒芒畢露
eng ang i u	毒蜂指：鋒芒畢露
eng ao e	狂蜂暴蜇
ang eng ao e	狂蜂暴蜇
u an ao	蜂毒貫腦
eng u an ao	蜂毒貫腦
ang ie ing	牙刃血指：血光滅頂
ve ang ie ing	牙刃血指：血光滅頂
i i ian	玉簪指：靈犀一點
ing i i ian	玉簪指：靈犀一點
i i II	代以擊石 靈犀一指 靈犀一指
ing i i II	靈犀一指 靈犀一指
ai ian i	斷脈劍氣
an ai ian i	斷脈劍氣
in ang II	奇蹟金剛指
i in ang II	奇蹟金剛指
an an II	羅漢禪指
o an an II	羅漢禪指
i ang II	一陽指
in II	天妖屠神法：吸陰式 幻陰指 般若伏魔訣：明心始 銀枝
an in II	幻陰指
a ai en	陰風爪：陰差拍門
in a ai en	陰風爪：陰差拍門
o an an	王婆扇扇
ang o an an	王婆扇扇
ao en	厲鬼招魂 無常招魂
ang ao en	無常招魂
u ang ao en	無常招魂
a o ing	夜叉索命
ie a o ing	夜叉索命
ei ei II	百鬼碎屍
ai ei ei II	百鬼碎屍
en u ing	無極爪：坤無定
： en u ing	無極爪：坤無定
a ang o	陰差陽錯 陰差陽錯
in a ang o	陰差陽錯 陰差陽錯
II i ai eng	十級颱風
ao ei ong ian	暴雷轟天
ei ing ian en	雷霆電震
ei ang eng	怒毀長城
u ei ang eng	怒毀長城
o ong ang	氣奪穹蒼 鎖龍網
i o ong ang	氣奪穹蒼
ie ang u	奪狼命爪：獵狼兔
： ie ang u	奪狼命爪：獵狼兔
ang u ing	野狼孤鷹
ie ang u ing	野狼孤鷹
ao u	大小著 聖火神功：焦土 餓剿虎
e ao u	餓剿虎
ang u II	狂狼逐日 瘋狼屠獅
eng ang u II	瘋狼屠獅
ou en	妖鎖囚神 赤煉鬼爪：猛鬼叩門
ei ou en	赤煉鬼爪：猛鬼叩門
eng ei ou en	赤煉鬼爪：猛鬼叩門
ei ou ai	餓鬼投胎
e ei ou ai	餓鬼投胎
ei an en	冤鬼纏身 千雷萬震
an ei an en	冤鬼纏身
e ei ing II	惡鬼凌遲
ei o ao an	鬼火燎原
ao en a	閻羅八殺爪：招魂殺
： ao en a	閻羅八殺爪：招魂殺
ve ai a	絕代殺
en II a	分屍殺
ei en a	幽幽冥影魄身法配合身法：鬼魂法 追魂殺
ing ian a	千軍萬馬驚天下 驚天殺
ong i a	動地殺
o a	天羅撒 閻羅殺
ian o a	天羅撒 閻羅殺
： o ao	刻骨銘心爪：刻骨銘心爪：破腦
ao ： o ao	刻骨銘心爪：刻骨銘心爪：破腦
u o an	刻骨破腕
e u o an	刻骨破腕
e an an	刻骨無骨折斷腕
u e an an	刻骨無骨折斷腕
e u ing in	刻骨銘心
u en ian	骨分肩
en ong i	刻骨離裸配合步法：無刻痕踪跡
e en ong i	刻骨離裸配合步法：無刻痕踪跡
en ing an	紫焰七勢：神鷹版
： en ing an	紫焰七勢：神鷹版
e II in	惡獅擒
e ang II	無的放矢 餓狼噬
e u	惡畜 靈蛇吐 魔光驚蟄伏
ing e u	靈蛇吐 魔光驚蟄伏
I in	獅子印 蝕月三殺：撕心
： I in	蝕月三殺：撕心
a ： I in	蝕月三殺：撕心
II o ian	四絕白骨爪：抽屍剝繭
ou II o ian	四絕白骨爪：抽屍剝繭
ou II ao	破頭蝕腦
o ou II ao	破頭蝕腦
​ u ang	搜索​​枯腸
o ​ u ang	搜索​​枯腸
u u an	屍骨如山
II u u an	屍骨如山
ing o o	神鷹八段錦爪法：神鷹奪魄
en ing o o	神鷹八段錦爪法：神鷹奪魄
ing ong ian	雄鷹沖天
ong ing ong ian	雄鷹沖天
ao a in	鷹爪挖心 鷹爪挖心
ing ao a in	鷹爪挖心 鷹爪挖心
ie a an ao	玄陰鬼爪：夜叉探爪
ei ao en	厲鬼招魂
i ei ao en	厲鬼招魂
ou ei en	鬼手追魂
ei ou ei en	鬼手追魂
I i	大漠魔狼殺：紫氣 雲煙四起
： I i	大漠魔狼殺：紫氣
a ： I i	大漠魔狼殺：紫氣
eng a	暴風沙 玄風沙 神風沙
an eng a	玄風沙
ao eng a	暴風沙
en eng a	神風沙
ao ：	五龍道： 龍翔爪：
ang ao ：	龍翔爪：
ong ang ao ：	龍翔爪：
ang an i	神鷹奪：鷹揚萬里
ing ang an i	神鷹奪：鷹揚萬里
eng ing o u	爭明奪目
ing eng ou	頸封喉
ie e i	離踝關節折翼
an ie e i	離踝關節折翼
en in u	分筋骨
eng an ou	鐵鵬斬首
ie eng an ou	鐵鵬斬首
a vn	大九展翼霸雲
i a vn	大九展翼霸雲
an i a vn	大九展翼霸雲
ing ing ong	無影鷹踪 翻天覆地絕人寰配合身肺法：無影鷹踪
u ing ing ong	無影鷹踪 翻天覆地絕人寰配合身肺法：無影鷹踪
ie an	千鬼邪元 涅磐 螺旋烈轉 變十三式：挖心裂膽
in ie an	變十三式：挖心裂膽
a in ie an	變十三式：挖心裂膽
an u ie	無遠弗屆
u an u ie	無遠弗屆
ian e	風馳電掣
II ian e	風馳電掣
eng II ian e	風馳電掣
ong ing u u	雄鷹撲兔
ou eng ei	血肉橫飛
ve ou eng ei	血肉橫飛
ian i i	倒天逆地 晴天霹靂 驚雷惡電惡電三行：驚雷三轟：雷電霹靂
ing ian i i	晴天霹靂
i ong ao	死氣沖霄 雪泥鴻爪
ve i ong ao	雪泥鴻爪
ie ian i	一瀉千里
i ie ian i	一瀉千里
u eng o	捕風捉
u eng u	啄目爭珠
o u eng u	啄目爭珠
ai i ao ve	海底撈月
ang o II	逆天破：天王破日 鷹王破日 鷹王破日
ing ang o II	鷹王破日 鷹王破日
an u ei	魂魂：二式玄武悲
II an u ei	魂魂：二式玄武悲
ve en ei	朱雀恨水
u ve en ei	朱雀恨水
ang ang ang	第十八式青龍掌掌掌
ong ang ang ang	第十八式青龍掌掌掌
in a	碎骨爪：碎骨擒拿
u in a	碎骨爪：碎骨擒拿
ei u in a	碎骨爪：碎骨擒拿
eng o ang	興風作浪
ing eng o ang	興風作浪
u an in	碎骨穿心
ei u an in	碎骨穿心
v in	碎骨欲心 雨霖
u v in	碎骨欲心
ei u v in	碎骨欲心
ou o ao	修羅道 裂頭破腦
ie ou o ao	裂頭破腦
ing ang	天鷹爪：千鷹並翔 靈象 鷹爪功：萬里鷹揚
i ing ang	鷹爪功：萬里鷹揚
an i ing ang	鷹爪功：萬里鷹揚
ing in ang	雙鷹擒蟒
ang ing in ang	雙鷹擒蟒
ing ian i	鷹鷹斂翼
ing ing ian i	鷹鷹斂翼
ing ong ve	五行轟岳 鷹鷹雄躍
ing ing ong ve	鷹鷹雄躍
ing u	借花敬佛 動靜著 飛鷹兔 鷹撲
ang ou	巨蠍昂首 醉八仙：呂洞賓斜插寶劍醉岳陽樓 魁星踢剛鬥 鷹搶球
ing ang ou	鷹搶球
ing ei	斷魂蠍釘腿 暴雷三式：暴雨驚雷 曠野驚雷 洹凝靈髓 萬劫鷹嘴 雷電合擊：電驚雷
ie ing ei	斷魂蠍釘腿 曠野驚雷 萬劫鷹嘴
an ie ing ei	萬劫鷹嘴
ei ei en	蠍尾追魂 鷹嘴追魂
ing ei ei en	鷹嘴追魂
an ing o II	殘鷹落日
ing an ong	飛鷹盤空
ei ing an ong	飛鷹盤空
ing an ao	鷹旋刀
ing o ai	麻鷹捉仔
a ing o ai	麻鷹捉仔
ei o u	鷹嘴奪珠
ing ei o u	鷹嘴奪珠
vn an u	鷹群亂撲
ing vn an u	鷹群亂撲
ao a ou	鷹爪抓手
ing ao a ou	鷹爪抓手
ao eng ou	鷹爪封喉
ing ao eng ou	鷹爪封喉
an ao in	鷹穿爪心
ing an ao in	鷹穿爪心
： ao ou in	鐵沙虎爪功：爪偷心
u o ve	飛虎虎破岳
u u o ve	飛虎虎破岳
ou ing II	虎口凌遲
u ou ing II	虎口凌遲
an ang in	九陰寒屍：反盪勁
： an ang in	九陰寒屍：反盪勁
ao o in	爆破勁
II en ei	九死白骨爪：再世輪迴
ai II en ei	九死白骨爪：再世輪迴
I i ong ao	死氣沖霄
II an ou	斷肢斬首
an II an ou	斷肢斬首
ai u ao	九死白骨爪 九陰白骨爪
I ai u ao	九死白骨爪
en v	七殘訣：身無寸縷 天香爪：色授魂與 火焚獄 火焚獄 炮烙焚軀 聖火焚軀
ou en v	天香爪：色授魂與
e ou en v	天香爪：色授魂與
ao v en	香銷玉損
ang ao v en	香銷玉損
ou en II u	勾魂蝕骨
ei ian I	百媚千姿
ai ei ian I	百媚千姿
ing ing ang	天鷹爪：千鷹並翔
ian ing ing ang	天鷹爪：千鷹並翔
ing ve II	天鷹攫日
ian ing ve II	天鷹攫日
an ian ve	刀淵劍岳 寒天絕 翻天月
ing an ou	千鷹萬壽
ian ing an ou	千鷹萬壽
en ing o II	神鷹破日
an i ong ei	鷹旋萬里空碎
en o o	白骨陰風爪：噬魂奪魄
II en o o	白骨陰風爪：噬魂奪魄
ing ang ang	獸穴法＆爪：鬼影幢幢
ei ing ang ang	獸穴法＆爪：鬼影幢幢
u u a a	虎虎抓沙
ie an an	血劫爪：千劫萬難
ian ie an an	血劫爪：千劫萬難
ve ing II	邪血凌遲
ie ve ing II	邪血凌遲
u o ou	幽冥鬼爪：白骨鎖喉
ai u o ou	幽冥鬼爪：白骨鎖喉
e ong	枯骨樂踴 電殛惡龍
u e ong	枯骨樂踴
u u e ong	枯骨樂踴
ao en II	冥爪分屍
ing ao en II	冥爪分屍
： ei en a	幽幽冥影魄身法配合身法：鬼魂法
ao v	張果老倒騎毛驢 暴雨 百毒爪：腥風暴雨 陰雷暴獄
eng ao v	百毒爪：腥風暴雨
ing eng ao v	百毒爪：腥風暴雨
u i u	毒爪擒龍配合毒功：腐肌蝕骨奇毒
II u i u	毒爪擒龍配合毒功：腐肌蝕骨奇毒
ou en II	鋼羽煞氣爪：啄肉分屍
o ou en II	鋼羽煞氣爪：啄肉分屍
ei ing u	飛鷹兔
ing en II	大鷹振翅
a ing en II	大鷹振翅
ian ie	灰飛煙滅 灰飛煙滅 羅剎魅神功：羅剎黃金戰鎧一滅：天滅 萬雷灰飛煙滅
ei ian ie	灰飛煙滅 灰飛煙滅 萬雷灰飛煙滅
ei ei ian ie	灰飛煙滅 灰飛煙滅 萬雷灰飛煙滅
ian ong u ai	鐵龍爪手：千龍出海
in ai u ao	九陰白骨爪
ve ao	化血爪 血雪爪
ve ve ao	血雪爪
a ve ao	化血爪
ou ang eng	勾魂鬼爪：血肉長城 血肉長城
ve ou ang eng	勾魂鬼爪：血肉長城 血肉長城
ei ao	奪魄鬼爪配合步法：魅影鬼爪 虎尾腳 虎皇腿：尾腳 韓湘子擒碗擊胸醉吹簫 餓鬼道
ing ei ao	奪魄鬼爪配合步法：魅影鬼爪
ei ing ei ao	奪魄鬼爪配合步法：魅影鬼爪
ong ei i	追雲腿：雲現踪霏迷
ian ong ei i	追雲腿：雲現踪霏迷
vn eng ong	雲風湧
ian I i	雲煙四起
vn ian I i	雲煙四起
ao eng en	天殘腿：天小風輪
ian ao eng en	天殘腿：天小風輪
ei ai	橫禍飛來
o ei ai	橫禍飛來
eng o ei ai	橫禍飛來
a eng en	天殘大風輪
an a eng en	天殘大風輪
ian ei en	天飛輪
an e an II	天殘射殘日
an ei ing	天殘尾釘
ian an ei ing	天殘尾釘
an o in	天殘破金
ian an o in	天殘破金
an o u	天殘破木
ian an o u	天殘破木
ian o II	天魔蝕 無相破元氣：開天破日 蠍天破石
ie ian o II	蠍天破石
eng o ing	捕風捉影 風神腿：捕風捉影
u eng o ing	捕風捉影 風神腿：捕風捉影
eng ong in ao	風中勁草
v ang eng	暴雨狂風
ao v ang eng	暴雨狂風
eng ing	三步風行 千里橫行 雷厲風行
i eng ing	千里橫行 雷厲風行
ei i eng ing	雷厲風行
an ou an	風捲樓殘
eng an ou an	風捲樓殘
eng u ou	神風怒吼
en eng u ou	神風怒吼
ei eng II	霹靂神腿：追風式
： ei eng II	霹靂神腿：追風式
ong i II	動地式
ian ang u ian	雷電神腿首六式：電光初現 雷電神腿：電光初現 雷電神首腿：電光初現
en ei a ang	春雷乍響
e ing ian u	蛇形電步 蛇形電步
o vn ei	捷若迅雷
ie o vn ei	捷若迅雷
ian ang an	聖王訣：外王六藝——傲書道：指點江山 電光斬
an er	如雷貫耳 如雷貫耳
ei an er	如雷貫耳 如雷貫耳
u ei an er	如雷貫耳 如雷貫耳
ang en ei	電光分飛 魔光七重天：魔光綻放春雷
ian ang en ei	電光分飛
ong ou ian	雷動九天 雷動九天 雷動九天
ei ong ou ian	雷動九天 雷動九天 雷動九天
ang u ong an	電光毒龍鑽 電光毒龍鑽 電光毒龍鑽
ing an vn	雷霆萬鈞 雷霆萬鈞
ei ing an vn	雷霆萬鈞 雷霆萬鈞
ei ian eng ong	雷電橫空 雷電橫空
ing ie	玄冰結 見性解 電光破嶺裂
o ing ie	電光破嶺裂
ang o ing ie	電光破嶺裂
ian en ei	雷電分飛
ei ian en ei	雷電分飛
ang ou an	電光首斬
ian ang ou an	電光首斬
ei ou	倒踢北斗 冥界門前恨回首 萬勢歸幽 邪邪大悲手 醉八仙：菩提樹下啖黃湯借醉三分戰意狂之虎漢：醉掛北斗 醉踏風火鬧龍宮一醉能解萬古問愁梵天破四面手之神：神醉守蒼生抱酲鎮震十方抱酲徜徉雲端上呼雷引電震十方之雷子：猴王酩酊鬧天宮十二變化無窮之醉猴鬧天宮手捎來千杯酒 雪女霜眉眼醺醺後發先至力萬鈞之太上老君：醉看紅塵少年不識酒滋味醉踏風火鬼神避之哪吒：醉酒倒踢北斗 雷麟霸腿：惡麟回首
in ei ou	雷麟霸腿：惡麟回首
e in ei ou	雷麟霸腿：惡麟回首
a ian an	麟霸千山
in a ian an	麟霸千山
in o ing	潛麟過嶺
ian in o ing	潛麟過嶺
eng v	暴蹄崩獄
i eng v	暴蹄崩獄
ao i eng v	暴蹄崩獄
a ian II	女媧煉石 拳箭腿：後發先至
ou a ian II	拳箭腿：後發先至
a II en	先發製人
ian a II en	先發製人
i i i	三箭元及第一
an i i i	三箭元及第一
u e ang II	無的放矢
ai u an ang	百步穿揚
e II	神光射日 穿雲射日 穿雲射日
vn e II	穿雲射日 穿雲射日
an vn e II	穿雲射日 穿雲射日
a ai ong	百發百中
ai a ai ong	百發百中
ei u ong an	箭腿毒龍鑽
a an ie	寒山梅花三疊
ei a an ie	寒山梅花三疊
v ing	三姍姍腳綠影
ao v ing	三姍姍腳綠影
an ao v ing	三姍姍腳綠影
o ei a	三落梅花
an o ei a	三落梅花
ao an ian en	乾坤裂山腿：倒轉乾坤
ei u ve	怒碎五嶽
u ei u ve	怒碎五嶽
ie en ou ou	裂分九州
er II	蟒蛇神腿：擇肥而食
ei er II	蟒蛇神腿：擇肥而食
e ei er II	蟒蛇神腿：擇肥而食
ang ou u in	昂首吐信
ang eng ong	毒蟒橫空
u ang eng ong	毒蟒橫空
ing ang u	蛇行蟒伏
e ing ang u	蛇行蟒伏
ve u	獠牙絕毒
a ve u	獠牙絕毒
ao a ve u	獠牙絕毒
e ei	靈裂蛇尾
ie e ei	靈裂蛇尾
ing ie e ei	靈裂蛇尾
ang an an	宇宙身法：身光玄閃 巨蟒盤纏
v ang an an	巨蟒盤纏
u ei in	萬毒歸心
an u ei in	萬毒歸心
vn u ai	逆天霸腿：顛雲覆海
ian vn u ai	逆天霸腿：顛雲覆海
i ei ou	倒踢北斗 雪女霜眉眼醺醺後發先至力萬鈞之太上老君：醉看紅塵少年不識酒滋味醉踏風火鬼神避之哪吒：醉酒倒踢北斗
ao i ei ou	倒踢北斗 雪女霜眉眼醺醺後發先至力萬鈞之太上老君：醉看紅塵少年不識酒滋味醉踏風火鬼神避之哪吒：醉酒倒踢北斗
a ei ian	霸碎天
ian u ei	逆天無悔
i ian u ei	逆天無悔
ong a ing	飛龍壓頂 飛龍壓頂
ei ong a ing	飛龍壓頂 飛龍壓頂
ang ong ian ei	雙龍剪水 雙龍剪水
i ang ong	霹靂狂龍 霹靂狂龍 霹靂狂龍
i i ang ong	霹靂狂龍 霹靂狂龍 霹靂狂龍
ang ong an u	狂龍亂舞
a ong ou ao	殺龍求道
： ei ing	追命十三腿：追影
ei ： ei ing	追命十三腿：追影
ian an ian	無間串蓮 若腿法：一念三千
i ian an ian	若腿法：一念三千
ing eng	佛性明燈 迎風
ing ing eng	佛性明燈
o ing ing eng	佛性明燈
ian an ong	一念圓融
i ian an ong	一念圓融
o u en	唯我獨尊 魔無神
ei o u en	唯我獨尊
I ai ei	蠍鞭腿：蝎子擺尾
ie I ai ei	蠍鞭腿：蝎子擺尾
ie e ian	毒蠍車鞭
u ie e ian	毒蠍車鞭
ei ei ian	蠍尾飛鞭
ie ei ei ian	蠍尾飛鞭
ie ang ou	巨蠍昂首
v ie ang ou	巨蠍昂首
ie ing ong	雙蠍行空
ang ie ing ong	雙蠍行空
a i ian	無影腳法：曇花一現
an a i ian	無影腳法：曇花一現
ing u ing	如影附形
u ing u ing	如影附形
ang e II	神光射日
en ang e II	神光射日
ao ang ong	日曜長空 霸王腿法：直搗黃龍
II ao ang ong	日曜長空 霸王腿法：直搗黃龍
ian vn	橫掃千軍 蠍尾掃千軍 醉八仙：呂洞賓醉酒提壺力千鈞 飛渡煙雲
ao ian vn	橫掃千軍 蠍尾掃千軍
eng ao ian vn	橫掃千軍
vn ou e	將軍抽車
ang vn ou e	將軍抽車
ang o ai	飛將奪帥
ei ang o ai	飛將奪帥
ei an e	碎山河
： ei ao	虎皇腿：尾腳
ei ： ei ao	虎皇腿：尾腳
u ian in	虎千斤
an eng an	雷雷旋風轉
ei an eng an	雷雷旋風轉
o i i	雷霆破霹靂
ing o i i	雷霆破霹靂
ong ei ou ang	芙蓉腿：蓉桂柳芳
an an u	不間斷亂舞 繁花似蘭芟鋤
II an an u	繁花似蘭芟鋤
o v	九死邪功：刀山火獄 金陽破獄 錦紅濁玉 離魔獄 驚雷魔雨
ong o v	錦紅濁玉
in ong o v	錦紅濁玉
a an ong	梅花三弄 錦花三弄
ei a an ong	梅花三弄
in a an ong	錦花三弄
eng an u u	霸腿七式：一將功成萬骨枯
en o ing	平步登天任我行
ian en o ing	平步登天任我行
a ing ao	叱吒風雲霸凌霄
vn a ing ao	叱吒風雲霸凌霄
an u i	攻無不克戰無敵 藍菩提
e an u i	攻無不克戰無敵
a ing ian a	千軍萬馬驚天下
e en ou ou	雷動山河震九州
i ai II	石破天氣蓋世
ian i ai II	石破天氣蓋世
v ang u	神風動：風雨江湖
eng v ang u	神風動：風雨江湖
ong eng vn	動風雲
ai ian II	飛云四式：雲開見日
vn ai ian II	飛云四式：雲開見日
ian vn ian	過眼雲煙
o ian vn ian	過眼雲煙
a ing ong	天馬神腿：天馬行空
ian a ing ong	天馬神腿：天馬行空
v o i	白駒過隙
ai v o i	白駒過隙
a ang i	七十二罡氣：一轉八罡氣 六轉四十八罡氣 飛馬張翼
ei a ang i	飛馬張翼
an a en eng	萬馬奔騰 萬馬奔騰
ao ian	十方奇招：離火燎天 惡浪滔天 洪荒浩焰 金晨曦：朝陽耀天
ang ao ian	惡浪滔天 洪荒浩焰 金晨曦：朝陽耀天
e ang ao ian	惡浪滔天
en u	困苦 山神震怒 雷霆魔功：雷神震怒
en en u	山神震怒 雷霆魔功：雷神震怒
an en en u	山神震怒
ei a ian i	飛馬獻蹄
ing an II	流星趕日
ou ing an II	流星趕日
ing an ing	移形換影
i ing an ing	移形換影
en i i	鬼神辟易
ei en i i	鬼神辟易
ve ei	陽世五絕腿
u ve ei	陽世五絕腿
II u ve ei	陽世五絕腿
II an ei	陰世幻腿
in II an ei	陰世幻腿
in ang ei	神奇金剛腿
i in ang ei	神奇金剛腿
e ian ao	毒刺腿：百蜇千螯
ai e ian ao	毒刺腿：百蜇千螯
ie ei ei en	蠍尾追魂
ou i II	蠍尾腿：倒柳逆施
ao ou i II	蠍尾腿：倒柳逆施
ie ao in	毒蠍撩陰
u ie ao in	毒蠍撩陰
ie an in	毒蠍穿心
u ie an in	毒蠍穿心
ei ao ian vn	蠍尾掃千軍
ie eng ou	天蠍腿：毒蠍封喉
u ie eng ou	天蠍腿：毒蠍封喉
ei ing en	蠍尾釘魂
ie ei ing en	蠍尾釘魂
in en ao	少林金剛腿：金伸腰
： in en ao	少林金剛腿：金伸腰
i ang ou	魁星踢剛鬥
ing i ang ou	魁星踢剛鬥
ei II ao	碎石腳
ie ou ao	裂頭腳
u ei ao	虎尾腳
en ie ing ei	斷魂蠍釘腿
u eng ian	飛云四步：一步登天
i u eng ian	飛云四步：一步登天
u eng ong	二步橫空
er u eng ong	二步橫空
u eng ing	三步風行
an u eng ing	三步風行
u en ou	四步神遊
I u en ou	四步神遊
ing ei ing	無定飛星 無影無踪：如影隨形
u ing ei ing	無定飛星 無影無踪：如影隨形
ing ou vn	形影流雲
ing ing ou vn	形影流雲
ing ou ong	影遊踪
en ang an an	宇宙身法：身光玄閃
ao u u	鳥渡術
o ei u	凌波微步
ing o ei u	凌波微步
ei o i	水挪移
II in ong	盤古真武訣：末日隱空
o II in ong	盤古真武訣：末日隱空
ang i a	兩極甲
ao an ing	兇暴亂影
ong ao an ing	兇暴亂影
u an i	斧玄擊
ei ing ong	雷霆轟
en en ei	離恨分飛
i en en ei	離恨分飛
ian eng en	一念成仁
i ian eng en	一念成仁
i ：	唐門四絕器：
ve i ：	唐門四絕器：
I ve i ：	唐門四絕器：
ou ong ong	暗：殺手空空
a ou ong ong	暗：殺手空空
a ing u	借花敬佛
ie a ing u	借花敬佛
ing an i	五星戰神氣：土星戰氣 木星戰氣 水星戰氣 火星戰氣 無形暗器 金星戰氣
u ing an i	五星戰神氣：土星戰氣 木星戰氣 無形暗器
an u ian II	暗無天日
u o i	萬物如我意
u u o i	萬物如我意
i ong an e	一器動山河
ang u ai	殺器：殺器護體金剛不壞
in ang u ai	殺器：殺器護體金剛不壞
ao ing e	劍器：劍嘯星河
ian ao ing e	劍器：劍嘯星河
in ie i	水銀瀉地
ei in ie i	水銀瀉地
ao ian i i	倒天逆地
ang ing ong	逆浪行凶
i ang ing ong	逆浪行凶
u ian vn	飛渡煙雲
ei u ian vn	飛渡煙雲
v ian ei	馭電追
ei v ong	割碎虛空 拳碎虛空
e ei v ong	割碎虛空
ian i ong	劍洗千里空 電劍殛空
i ian i ong	劍洗千里空
a u e	殺無赦
ian u ang	劍無雙 降千佛掌
an o	羅漢破 鄂家神功：紫旋破 阿鼻道：無間旋渦
ian an o	阿鼻道：無間旋渦
u ian an o	阿鼻道：無間旋渦
ou ou ao	九幽爪
ie i ei	滅寂腿
i en ang	九陽五絕：霹靂神掌 離魂掌
ou o II	修羅指
ve en	阿鼻冥岳身
ing ve en	阿鼻冥岳身
i ing ve en	阿鼻冥岳身
ao ai ang	神伏州魔訣：驚濤白浪
ing ao ai ang	神伏州魔訣：驚濤白浪
an ei v ong	拳碎虛空
ing ou ing	飛影流星
ei ing ou ing	飛影流星
ian a ang	飛蓮踏浪
ei ian a ang	飛蓮踏浪
eng an u	火鳳亂舞 狂風亂舞
ang eng an u	狂風亂舞
ing in II	般若伏魔訣：明心始
： ing in II	般若伏魔訣：明心始
ian ing ie	見性解
II a i	釋法義
i ao	菩提道 阿鼻道 阿鼻道
u i ao	菩提道
o an o	羅漢破
ou ie ai	六業衰
e u u	般若伏伏
o e u u	般若伏伏
ian ang ao	無間道：天上道
： ian ang ao	無間道：天上道
en ian ao	人間道
e ei ao	餓鬼道
v ao	地獄道
i v ao	地獄道
ing ：	如意天經： 易筋經： 貝葉經： 陰世奇經： 飲恨魔經：
o ing ：	飲恨魔經：
en o ing ：	飲恨魔經：
ve ong	一刀絕空 晶靈聖手：馭虛攫空
v ve ong	晶靈聖手：馭虛攫空
v v ve ong	晶靈聖手：馭虛攫空
ao an ong	明交暗融
ing ao an ong	明交暗融
u ei ong	風舞雷動
eng u ei ong	風舞雷動
ong ang II	無弓放矢
u ong ang II	無弓放矢
o ian ao	蒼狼四絕：風沙霸拳：狼王壓頂朔漠天刀
o o ian ao	蒼狼四絕：風沙霸拳：狼王壓頂朔漠天刀
II en o	修羅絕道：青焰神腿：惡獸噬神羅
ou II en o	修羅絕道：青焰神腿：惡獸噬神羅
ou o en	滅佛修黑雷拳：暴雷拳裂裂金身：屠羅無極修羅震
i ou o en	滅佛修黑雷拳：暴雷拳裂裂金身：屠羅無極修羅震
u i ou ei	修羅無極修腿
ang en an	紫陽神拳
I ang en an	紫陽神拳
en an i	滅神三極
ie en an i	滅神三極
： i ai	破邪三限：地脈
ian ： i ai	破邪三限：地脈
a o en ang	達摩三絕：達摩神掌
a o en ian	達摩神劍
o en ei	達摩神腿
a o en ei	達摩神腿
ian an ei	天殘三絕：天殘腿
： ian an ei	天殘三絕：天殘腿
II in ang	十心掌
en eng ve	皇極驚天訣：焚城訣
： en eng ve	皇極驚天訣：焚城訣
ie ang ve	滅陽訣
an ai ve	翻海訣
o i ve	破地訣
ing ian ve	驚天訣
ei ian i i	驚雷惡電惡電三行：驚雷三轟：雷電霹靂
ai en ong	遙恆派神功
eng ai en ong	遙恆派神功
ang en ong	日月神鑑：烈陽神功 無相神功
u ang en ong	無相神功
ang u in	遙極樂功：採陽補陰
ai ang u in	遙極樂功：採陽補陰
ou ：	遙三陰手：
in ou ：	遙三陰手：
an in ou ：	遙三陰手：
ang ai an	閻王掌：閻王開山
ian ang ai an	閻王掌：閻王開山
ang in en	無常爪：無常擒魂
u ang in en	無常爪：無常擒魂
ang ai u	無常開路
u ang ai u	無常開路
ang ai in	無常采心
u ang ai in	無常采心
in ang eng	陰陽無常判官指：一指陰陽恆
II in ang eng	陰陽無常判官指：一指陰陽恆
i i en ang	九陽五絕：霹靂神掌
ang en ian	九陽神劍 藍采和度沈痾收花把子湘分獻
ou ang en ian	九陽神劍
ang a i	陰陽大移
in ang a i	陰陽大移
vn ang	火雲掌
o vn ang	火雲掌
ie ang ao	烈陽刀
ong ai an	乾坤絕絕無量/乾坤無定震動百里：乾坤原：天道：雷動九天火燎坤：天驚地循環：風兮破天驚地：水兮滔天火兮焚野山兮鬼神驚：岳東泰山
ve ong ai an	乾坤絕絕無量/乾坤無定震動百里：乾坤原：天道：雷動九天火燎坤：天驚地循環：風兮破天驚地：水兮滔天火兮焚野山兮鬼神驚：岳東泰山
ve eng an	北岳恆山 南嶽衡山
an ve eng an	南嶽衡山
ve ong an	中嶽嵩山
ong ve ong an	中嶽嵩山
ve a an	西嶽華山
i ve a an	西嶽華山
ei ve eng an	北岳恆山
ei i ong	五嶽齊轟雷兮天地：萬雷齊轟
an ei i ong	五嶽齊轟雷兮天地：萬雷齊轟
in ang u ao	陰陽三式：陰陽毒爪
eng u ang	陰風毒掌
in eng u ang	陰風毒掌
ie ang u an	烈陽毒拳
ian ang ie i	無殛電：電網瀉地
ao an e	電爪戰車
ian ao an e	電爪戰車
i ian en	如意電震 無殛電輪 霹靂電震
i i ian en	霹靂電震
u i ian en	如意電震 無殛電輪
ian ang in ong	雷電門三大絕招：電網擒龍
i e ong	電殛惡龍
ian i e ong	電殛惡龍
ong ou	神奇金剛：誅魅普渡功咒
u ong ou	神奇金剛：誅魅普渡功咒
u u ong ou	神奇金剛：誅魅普渡功咒
a ei ou	邪邪大悲手 醉八仙：菩提樹下啖黃湯借醉三分戰意狂之虎漢：醉掛北斗
ie a ei ou	邪邪大悲手
ao in ang in	伏妖金剛印
ang ian u ang	降千佛掌
i a ou	閻王十殺令：剝皮挖肉
o i a ou	閻王十殺令：剝皮挖肉
an ao an	十萬刀山
II an ao an	十萬刀山
ian o ai	無邊火海
u ian o ai	無邊火海
eng I	餓鬼爭飼
ei eng I	餓鬼爭飼
e ei eng I	餓鬼爭飼
II ei u	煉石碎骨
ian II ei u	煉石碎骨
ing ing ei	洹凝靈髓
an ing ing ei	洹凝靈髓
ou a ao	虎頭鍘刀
u ou a ao	虎頭鍘刀
II an en	分屍散魂
en II an en	分屍散魂
o en v	火焚獄 火焚獄 炮烙焚軀 聖火焚軀
ao o en v	炮烙焚軀
II an ong	十三龍
ei ong ao ou	十三象：撕心肺龍爪手
vn ang a an	橫掃千軍象拔拳
ang u o	力貫萬象步墮
an ang u o	力貫萬象步墮
ong ei ei	刁鑽詭裂龍尾腿
ie ong ei ei	刁鑽詭裂龍尾腿
a ei	穿金破石像牙錐
ang a ei	穿金破石像牙錐
II ang a ei	穿金破石像牙錐
u u ong in	刀槍不入龍鱗
o o e	暗黑之神魔般若
en o o e	暗黑之神魔般若
ian ang o II	逆天破：天王破日
er ing	逆天而行
ian er ing	逆天而行
i ian er ing	逆天而行
en ao II	花間遊：醉入花叢人笑痴
ong en ao II	花間遊：醉入花叢人笑痴
ou eng	採菊南籬愁秋風
ou ou eng	採菊南籬愁秋風
i ou ou eng	採菊南籬愁秋風
i ang ei	蝶舞翩翩戲香蕊
ian i ang ei	蝶舞翩翩戲香蕊
ang i ang	狂蜂飛釀蜜忙
ei ang i ang	狂蜂飛釀蜜忙
eng i u	雨芭打蕉鳳棲梧
ao eng i u	雨芭打蕉鳳棲梧
eng u a	化作春泥更護花
i eng u a	化作春泥更護花
i ian vn	醉八仙：呂洞賓醉酒提壺力千鈞
u i ian vn	醉八仙：呂洞賓醉酒提壺力千鈞
ei u an	漢鐘醉步壇
ong ei u an	漢鐘醉步壇
ou o ou ou	曹國師仙人敬酒鎖喉扣
i ian an	張果老醉酒拋杯踢連環
ei i ian an	張果老醉酒拋杯踢連環
an ao o	藍忘機采和單提敬酒攔腰破
ou an ao o	藍忘機采和單提敬酒攔腰破
ei ei ao	韓湘子擒碗擊胸醉吹簫
ong ei ei ao	韓湘子擒碗擊胸醉吹簫
ve ang ou	醉八仙：呂洞賓斜插寶劍醉岳陽樓
ei ve ang ou	醉八仙：呂洞賓斜插寶劍醉岳陽樓
i ao v	張果老倒騎毛驢
ao i ao v	張果老倒騎毛驢
ai ai ao	鐵拐李系葫蘆腰間離拐摔倒
i ai ai ao	鐵拐李系葫蘆腰間離拐摔倒
ai ao ao	曹國手指雲陽見板左右摔倒在高橋
ao ai ao ao	曹國手指雲陽見板左右摔倒在高橋
ou ou an	何仙姑睡睡象象床左右揉反
o ou ou an	何仙姑睡睡象象床左右揉反
ao an an	漢鍾離手使陽寶扇扇 銅像功：銅拳：銅砲穿山
ang ao an an	漢鍾離手使陽寶扇扇
I ang en ian	藍采和度沈痾收花把子湘分獻
ei a ei ou	醉八仙：菩提樹下啖黃湯借醉三分戰意狂之虎漢：醉掛北斗
I ai	大千世界佛自在 酒醉盪四海
ang I ai	酒醉盪四海
ei ang I ai	酒醉盪四海
eng a ong ong	夢打銅鐘
eng o en	怒碎風火輪
ei eng o en	怒碎風火輪
II en ou	海市蜃樓 醉眼看天庭擎槍指神州
ang II en ou	醉眼看天庭擎槍指神州
ian ei ou	醉踏風火鬧龍宮一醉能解萬古問愁梵天破四面手之神：神醉守蒼生抱酲鎮震十方抱酲徜徉雲端上呼雷引電震十方之雷子：猴王酩酊鬧天宮十二變化無窮之醉猴鬧天宮手捎來千杯酒
ai ian ei ou	醉踏風火鬧龍宮一醉能解萬古問愁梵天破四面手之神：神醉守蒼生抱酲鎮震十方抱酲徜徉雲端上呼雷引電震十方之雷子：猴王酩酊鬧天宮十二變化無窮之醉猴鬧天宮手捎來千杯酒
： in	五行氣：金 快慢九字訣：臨
ve ： in	快慢九字訣：臨
I ve ： in	快慢九字訣：臨
： o an	兩極三問：問風式：渦旋
II ： o an	兩極三問：問風式：渦旋
： en ong	烈風旋渦問雷式：震空
II ： en ong	烈風旋渦問雷式：震空
ian ei an en	千雷萬震
： i ong	霹靂震空問電式：殛空
II ： i ong	霹靂震空問電式：殛空
ian an ve	紫電斷岳
I ian an ve	紫電斷岳
ian ian i ong	電劍殛空
ei i i	天雷霹靂：天雷霹靂 神雷一擊 震雷霹靂
ian ei i i	天雷霹靂：天雷霹靂
ian ei ong ing	千雷轟頂 天雷轟頂
i ian ei	霹靂天雷
i i ian ei	霹靂天雷
an u ang	如意七轉：運轉無常
vn an u ang	如意七轉：運轉無常
an in ang	二轉陰陽 羅殿裡判陰陽
er an in ang	二轉陰陽
an ou e	三轉六合
an an ou e	三轉六合
an a ang	四轉八方
I an a ang	四轉八方
an en II	五轉分屍
u an en II	五轉分屍
ou an ei	六轉腿
an en ei	七轉輪迴
i an en ei	七轉輪迴
ei ian ai	神行八法：精衛填海
ing ei ian ai	神行八法：精衛填海
ong v o	祝融浴火
u ong v o	祝融浴火
ong ong i an	共工移川
ao u ei	有巢築壘
ou ao u ei	有巢築壘
en i ie	雷震劈邪
ei en i ie	雷震劈邪
i a a	伏羲畫卦 天地大法
u i a a	伏羲畫卦
v a ian II	女媧煉石
an u ai ian	盤古開天
an eng vn	完美神技：紛擾擾斷風雲
ao an eng vn	完美神技：紛擾擾斷風雲
a ong en	蕭蕭殺紅塵
ao a ong en	蕭蕭殺紅塵
ie ei en	蒼蒼茫茫滅碎坤
ang ie ei en	蒼蒼茫茫滅碎坤
ei o ao	唯我道
o ao ian	十方奇招：離火燎天
i o ao ian	十方奇招：離火燎天
o vn	地水破軍
ei o vn	地水破軍
i ei o vn	地水破軍
vn eng	乾坤巽風
en vn eng	乾坤巽風
ian en vn eng	乾坤巽風
en an ve	坤崙斷岳
en en an ve	坤崙斷岳
en ei i i	神雷一擊 震雷霹靂
e i ei an	澤地歸元
i an ing i	地轉星移
ie i ve	天滅地絕
ian ie i ve	天滅地絕
v v ie	十方俱俱滅
ang v v ie	十方俱俱滅
ao ou ang	聖火神功：爆肘撞
： ao ou ang	聖火神功：爆肘撞
o ei i	烈火飛膝
ie o ei i	烈火飛膝
o ian ian	烽火連天
eng o ian ian	烽火連天
ie o ai an	烈火開山
o ong in	烈火攻心
ie o ong in	烈火攻心
o ian an	火箭拳
o ian an vn	火箭穿雲
o ao ou in	火烙手印
I ang	四陽 次陽 淨土慈航 火舞驕陽照四方 風雲我自王
ao I ang	火舞驕陽照四方
ang ao I ang	火舞驕陽照四方
u i ang	火舞激揚
o u i ang	火舞激揚
eng o en an	聖火神拳
eng o ao an	聖火燎原
eng o u i	聖火護體
eng o en v	聖火焚軀
ai ian o II	無相破元氣：開天破日
II ei o	穹天赤雷破
ian II ei o	穹天赤雷破
in a a	七逆寒天劫：寒麟化甲
an in a a	七逆寒天劫：寒麟化甲
ong ie	中階 天人共劫 蟠龍洩
en ong ie	天人共劫
ian en ong ie	天人共劫
ei ang ao	逆天無我：逆水狂濤
i ei ang ao	逆天無我：逆水狂濤
an i ie	天旋地劫
ian an i ie	天旋地劫
ing ai	不死印法：陰風送葬索命來
o ing ai	不死印法：陰風送葬索命來
ang o ing ai	不死印法：陰風送葬索命來
ei an an	生離死別催肝幻
ie ei an an	生離死別催肝幻
en ei ou	冥界門前恨回首
ian en ei ou	冥界門前恨回首
ang I	視死如歸闖司 黑絕魔經：忘死
ei ang I	視死如歸闖司
u ei ang I	視死如歸闖司
i an in ang	羅殿裡判陰陽
ang ian eng	奈何橋上身忘前生
en ang ian eng	奈何橋上身忘前生
o en a	萬劫不復墮輪迴配合法：魔身法
： o en a	萬劫不復墮輪迴配合法：魔身法
v ai II	不死七幻：以虛還實
i v ai II	不死七幻：以虛還實
a ai an	偏勞法概全
ao a ai an	偏勞法概全
i en II	以身試
ai i i II	代以擊石
ou ei u	以有為無
i ou ei u	以有為無
en u ie	以身入滅
i en u ie	以身入滅
e v	神魔同體訣：善惡聚
an e v	神魔同體訣：善惡聚
： an e v	神魔同體訣：善惡聚
ie ei	正邪會 穿心鐵鎚
eng ie ei	正邪會
en o e	神魔合
o II ou	天魔功：天魔四蝕：天魔蝕肉
ian o II ou	天魔功：天魔四蝕：天魔蝕肉
ian o II u	天魔蝕骨
II ing	天魔蝕經
o II ing	天魔蝕經
ian o II ing	天魔蝕經
ian o in en	天魔五絕：天魔金身 閻羅陰神
o i e	天魔極樂
ian o i e	天魔極樂
ian o u	天魔怒
o ie i	大天魔場：天魔解體 天魔裂地
ian o ie i	大天魔場：天魔解體 天魔裂地
o I ian	天魔撕天
ian o I ian	天魔撕天
ian o ao	大天魔刀 天魔刀：小天魔刀
ao ian o ao	天魔刀：小天魔刀
a ian o ao	大天魔刀
ian o ei	天魔錐
ian o an u	天魔亂舞
i in II	天妖屠神法：吸陰式
： i in II	天妖屠神法：吸陰式
ao en o	刁魂破
ian II II	吸天蝕日
i ian II II	吸天蝕日
ian en eng	衝千魂城
ong ian en eng	衝千魂城
o ou en	妖鎖囚神
ao o ou en	妖鎖囚神
ei ao ou	幻魅妖球
an ei ao ou	幻魅妖球
an ian i	妖亂天地
ao an ian i	妖亂天地
ie II	妖極滅世 義和大日玄功：吼天戰拳，吼天滅世
i ie II	妖極滅世
ao i ie II	妖極滅世
ve ：	六神訣： 軒轅驚天訣：
en ve ：	六神訣：
ou en ve ：	六神訣：
en i an	雷神疾：雷神疾閃
ei en i an	雷神疾：雷神疾閃
en i ian	雷神疾電
ei en i ian	雷神疾電
ie ai ie	雷神疾旋金剛：內解外解
ei ie ai ie	雷神疾旋金剛：內解外解
in ang ie i	解金剛解肌
in ang a	金剛甲
ie in	羅漢禦：羅漢卸勁
an ie in	羅漢禦：羅漢卸勁
o an ie in	羅漢禦：羅漢卸勁
an ie ing	羅漢卸兵
o an ie ing	羅漢卸兵
ie ve	羅漢卸岳
an ie ve	羅漢卸岳
o an ie ve	羅漢卸岳
in an ing	觀音亂：觀音亂影
an in an ing	觀音亂：觀音亂影
in an II	觀音亂世
an in an II	觀音亂世
an ai	觀音亂脈
in an ai	觀音亂脈
an in an ai	觀音亂脈
in o ie	觀音火劫
an in o ie	觀音火劫
an in an	千手百臂觀音亂
i an in an	千手百臂觀音亂
a ie ing	菩薩滅：菩薩滅頂
u a ie ing	菩薩滅：菩薩滅頂
ai o i	菩薩滅如來破：如來破極
u ai o i	菩薩滅如來破：如來破極
in ian ian	花火煉：焮天焰
： in ian ian	花火煉：焮天焰
ve o ing	血火鼎
ve o en ian	血火沉天
ve v	地心火：熔沼血獄 阿絕獄
ao ve v	地心火：熔沼血獄
ong ao ve v	地心火：熔沼血獄
v ang an	火龍獄雙轉
ong v ang an	火龍獄雙轉
u ong u	煉爐烘爐
ian u ong u	煉爐烘爐
en o ou	煉獄真火球
v en o ou	煉獄真火球
an ie an	螺旋烈轉
o an ie an	螺旋烈轉
o o ian	真火托天
en o o ian	真火托天
o ei eng	地火圍城
i o ei eng	地火圍城
ing o ou	冥火球
o ong ian an	火龍千轉
II i i	天穹五道：冬日熙熙
ong II i i	天穹五道：冬日熙熙
eng u ing	南鋒無定
an eng u ing	南鋒無定
ian ou u	西天求渡
i ian ou u	西天求渡
ing ei ang	北冥飛傷
ei ing ei ang	北冥飛傷
ie i ong	四炁歸宗萬劫一空
an ie i ong	四炁歸宗萬劫一空
eng en II	真魔天道：斬鐵暴風殺血魅邪魂劫封神虎殺陣：封神式
： eng en II	真魔天道：斬鐵暴風殺血魅邪魂劫封神虎殺陣：封神式
II i	斷虎式修羅怒殺腿魔狼戰身滅天之翼 虎伏之氣 降龍伏虎之氣：降龍之氣
ian II i	斷虎式修羅怒殺腿魔狼戰身滅天之翼
ie ian II i	斷虎式修羅怒殺腿魔狼戰身滅天之翼
I an o	鄂家神功：紫旋破
： I an o	鄂家神功：紫旋破
an I ian	紫旋撕天
I an I ian	紫旋撕天
I an o ve	紫旋破岳
an ong an an	紫旋龍捲纏
ou ian en	意守乾坤
i ou ian en	意守乾坤
II u ai	神馳物外
en II u ai	神馳物外
ao u i	逍遙無極 風雲合招：天道無極
ao ao u i	逍遙無極
： ian ie	羅剎魅神功：羅剎黃金戰鎧一滅：天滅
ie ： ian ie	羅剎魅神功：羅剎黃金戰鎧一滅：天滅
en ie	人滅 刀章妙炒：刀章三訣：橫紋切
ou ao ei	三界雷霆二霸：九霄雷
： ou ao ei	三界雷霆二霸：九霄雷
ou ing ong	幽冥空
ei i a	雷冥空霸四絕：鬼劈霸
： ei i a	雷冥空霸四絕：鬼劈霸
ang ve a	穹蒼血甲 電光攫霸
ian ang ve a	電光攫霸
ou ing an	流星貫
ing o ong	螢火轟
ie u ao	魔：邪無道
： ie u ao	魔：邪無道
ing i ian	青鑑秘卷：青氣現
： ing i ian	青鑑秘卷：青氣現
ing ian ai	青天開
ing ao ao	青濤嘯
ing vn an	青雲轉
： an ing II	閃電四式：幻影式
ei ao II	圍剿式
ao o II	爆破式
ong ao an an	銅像功：銅拳：銅砲穿山
a ong eng	銅砲連環銅腳：銅馬縱橫
ong a ong eng	銅砲連環銅腳：銅馬縱橫
ong ou ong	銅蹄踏雪銅頭：銅頭功
： ong ou ong	銅蹄踏雪銅頭：銅頭功
ou in ong	鐵骨奇功：鐵手擒龍
ie ou in ong	鐵骨奇功：鐵手擒龍
ai ang ie	鐵拐撞鐵
ie ai ang ie	鐵拐撞鐵
an o ong	鐵拳破空
ie an o ong	鐵拳破空
in ie ei	穿心鐵鎚
an in ie ei	穿心鐵鎚
i ong eng	鐵蹄縱橫
ie i ong eng	鐵蹄縱橫
ao ong in	獸神訣：野豹衝林
ie ao ong in	獸神訣：野豹衝林
ao ong an	虎嘯中原
u ao ong an	虎嘯中原
ong ang ei an	熊掌推山
ai ou ong ei	百獸同悲
ing ei o	雷霆魔功：驚雷破
： ing ei o	雷霆魔功：驚雷破
ei ing i i	雷霆一擊
ei en en u	雷霆魔功：雷神震怒
I i ou	紫氣天羅：紫氣收
： I i ou	紫氣天羅：紫氣收
i o ie	氣破界
u i ie	誅天訣：天誅地滅
ian u i ie	誅天訣：天誅地滅
ian ong i	冰天凍地
ing ian ong i	冰天凍地
ou i an	殺神四式：天萬愁地慘
an ou i an	殺神四式：天萬愁地慘
ing u an	生靈塗炭
eng ing u an	生靈塗炭
en v ie	神俱滅
u en v	七殘訣：身無寸縷
en u en v	七殘訣：身無寸縷
ing ie ou	庖丁解牛
ao ing ie ou	庖丁解牛
in o	三火歸元功：陰火 分筋錯
en in o	分筋錯
ve ai ao	血在燒
ing o ei	吸裂精奪髓
ie ing o ei	吸裂精奪髓
： ian i	盤古五極：天極
i ： ian i	盤古五極：天極
ian ang ong	刀劍雙絕：一劍藏空
i ian ang ong	刀劍雙絕：一劍藏空
ao ve ong	一刀絕空
i ao ve ong	一刀絕空
ian u ong	百劍無踪
ai ian u ong	百劍無踪
ao o i	十刀破極
II ao o i	十刀破極
an ian ei an	萬劍歸元
ao u in	千刀不盡
ian ao u in	千刀不盡
e ang ian	殺破狼：餓狼天
： e ang ian	殺破狼：餓狼天
a II	嘯狼牙噬
ang a II	嘯狼牙噬
ao ang a II	嘯狼牙噬
ang ang u II	狂狼逐日
ang eng ian	餓狼聲天
e ang eng ian	餓狼聲天
ang ou ian	狂狼吼天
ang ang ou ian	狂狼吼天
ve an	殘殺月斬
a ve an	殘殺月斬
an a ve an	殘殺月斬
ang ang u ong	雙狼出洞
u ai u	鋒寒式：塞外戈狼煙四起土埋骨
i u ai u	鋒寒式：塞外戈狼煙四起土埋骨
a eng i	熱沙聲七
e a eng i	熱沙聲七
ai II en ou	海市蜃樓
ang ie ing ei	曠野驚雷
eng ao	冥生道 冥生道 回生道 回生道 大漠風暴 無間轉生道
o eng ao	大漠風暴
a o eng ao	大漠風暴
： ong u i	提證法神功：紅菩提
v eng vn	六道萬行御風雲
ing v eng vn	六道萬行御風雲
en ian en	觀心千手震乾坤
ou en ian en	觀心千手震乾坤
u ao o	神龍爪誅妖魔
ao u ao o	神龍爪誅妖魔
ei u i	黑菩提
en u u ong	雷虛忿怒怒空
I u i	紫菩提 紫菩提
ai i u ang	四方如來氣無量
en ang ong	九陽神功：移形分陽功 烈火焚陽功
ing en ang ong	九陽神功：移形分陽功
i i ang	二陽霹靂掌 霹靂象
ang i i ang	二陽霹靂掌
o ang an	幻影破陽拳
ing o ang an	幻影破陽拳
ie ang ei	百變烈陽腿
ian ie ang ei	百變烈陽腿
u ang ao	五路陽爪
u u ang ao	五路陽爪
ai ang in	旋風太陽勁
eng ai ang in	旋風太陽勁
o en ang ong	烈火焚陽功
u an ang II	八步穿陽指
ie ang in	烈陽勁
： ian o	五道邪元：千破
an ： ian o	五道邪元：千破
a e	蜘蛛網殺蛇
ang a e	蜘蛛網殺蛇
u ang a e	蜘蛛網殺蛇
ai u ong eng	百毒縱橫
I ong ai ei	蝎子洞擺尾
u ie an ao	五毒邪元爪
ei ie an	千鬼邪元
ian ei ie an	千鬼邪元
i u ing	唐手武道：天地無情
ian i u ing	唐手武道：天地無情
an ao ou	貫嘯手
a i ou	觀空大劈手
ong a i ou	觀空大劈手
ian i eng ing	千里橫行
a an e	拔山河
ao an ei	寒刀斷水
an ao an ei	寒刀斷水
ian ao u i	風雲合招：天道無極
e u ang	功德無量 摩訶無量 舍無量
o e u ang	摩訶無量
ong ： an ie	鬼劫仙功：纏結
II ei ou	萬勢歸幽
an II ei ou	萬勢歸幽
ou u ang	千手無量 萬壽無疆
an ou u ang	萬壽無疆
in en ei	無盡輪迴
u in en ei	無盡輪迴
ei o an	黑煞魔功：天雷破山
ian ei o an	黑煞魔功：天雷破山
ian ong ao	惡電沖霄
e ian ong ao	惡電沖霄
ei o ve	二雷破岳 五雷破岳
er ei o ve	二雷破岳
u ei o ve	五雷破岳
ei o v	驚雷魔雨
ing ei o v	驚雷魔雨
ei ang o	雙雷盪魄
ang ei ang o	雙雷盪魄
ong ei o ing	魍魎混元勁：第七重鬼索命
ei u en ao	第八重鬼哭鬼哭神號
ei en ao	第十三重鬼哭鬼神號 鬼門道 鬼門道
u ei en ao	第十三重鬼哭鬼神號
ang o in	天心蓮環：包藏禍芯
ao ang o in	天心蓮環：包藏禍芯
ian u ian	雙蓮吐艷
ang ian u ian	雙蓮吐艷
ai eng II	節外生枝
ie ai eng II	節外生枝
v ian ian	風雨蓮天
eng v ian ian	風雨蓮天
a ian u	借花獻佛
ie a ian u	借花獻佛
u ian an ian	無間串蓮
： ian u	萬世流芳配合身法：蓮步
a ： ian u	萬世流芳配合身法：蓮步
ing ong u	破蓮八著：輕重著
： ing ong u	破蓮八著：輕重著
a ao u	大小著
ang an u	方圓著
ong ing u	動靜著
ing an u	明暗著
v II u	虛實著
an u eng	輪迴轉苦生
ei an u eng	輪迴轉苦生
： e	愁苦的訣竅：惡
ao ： e	愁苦的訣竅：惡
ve ao ： e	愁苦的訣竅：惡
e ai	餓海
an u an	慘無慘
i ang ang	血神經：血氣方剛
ve i ang ang	血神經：血氣方剛
e en ou	血河奔流
ve e en ou	血河奔流
ve en ing	血神凝
e an	血洗河山
i e an	血洗河山
ve i e an	血洗河山
an ang ong	血染長空
ve an ang ong	血染長空
eng ai	血糖澎湃
ang eng ai	血糖澎湃
ve ang eng ai	血糖澎湃
ou ve	有血
v ing ei	暴雷三式：暴雨驚雷
ao v ing ei	暴雷三式：暴雨驚雷
ing i en	雷霆殛震
ei ing i en	雷霆殛震
ang ang II	暗空神訣：蒼狼勢
： ang ang II	暗空神訣：蒼狼勢
e u II	惡蝠勢
ie ing II	夜鷹勢
u ou o	冥府修羅
ing u ou o	冥府修羅
ao an en	六道戰神
ou ao an en	六道戰神
o ong u ian	冰火五重天：火龍初現 冰火五重天：火龍初現
ong ong ao	冰龍沖霄 冰龍沖霄
ing ong ong ao	冰龍沖霄 冰龍沖霄
ian i ing	龍潛迷冰 龍潛迷冰
ong ian i ing	龍潛迷冰 龍潛迷冰
eng o an	龍騰火淵 龍騰火淵
ong eng o an	龍騰火淵 龍騰火淵
ing ai ong	冰海龍 冰海龍
ong ao II	焰龍抱日 焰龍抱日
ian ong ao II	焰龍抱日 焰龍抱日
ong an ve	雪龍翻月 雪龍翻月
ve ong an ve	雪龍翻月 雪龍翻月
v ong ian	冰鎖虛空煉 冰鎖虛空煉
o v ong ian	冰鎖虛空煉 冰鎖虛空煉
I u ang	四梵無量心：慈無量 慈無量
： I u ang	四梵無量心：慈無量
ou II	梵天救世
ian ou II	梵天救世
an ian ou II	梵天救世
u I ang	淨土慈航
ing u I ang	淨土慈航
ei u ang	悲無量
u ai u ian	苦海無邊
e ian in	極樂仙音
i e ian in	極樂仙音
o ian ang	刀劍合一：刀羅劍網
ao o ian ang	刀劍合一：刀羅劍網
ao an ian ve	刀淵劍岳
a ian ve	刀霸劍絕
ao a ian ve	刀霸劍絕
II ian ang an	聖王訣：外王六藝——傲書道：指點江山
ong e	筆走龍蛇
ou ong e	筆走龍蛇
i ou ong e	筆走龍蛇
vn u	天驚石破樂藝：風急雲怒
i vn u	天驚石破樂藝：風急雲怒
eng i vn u	天驚石破樂藝：風急雲怒
o I ang	風雲我自王
vn o I ang	風雲我自王
an en ing	楚莊王中原問鼎
ong an en ing	楚莊王中原問鼎
i an an	劍傲英雄禮道：盛意拳拳
eng i an an	劍傲英雄禮道：盛意拳拳
v i	止約於禮 金縷衣
ve v i	止約於禮
II ve v i	止約於禮
in v	拜揖門楣射藝：射石飲羽
II in v	拜揖門楣射藝：射石飲羽
e II in v	拜揖門楣射藝：射石飲羽
an u ing in	戰鼓鳴金
eng en ie	刀章妙炒：刀章三訣：橫紋切
： eng en ie	刀章妙炒：刀章三訣：橫紋切
II ai an	直排斬
： ian an	斜側削妙炒四法：前鏟
a ： ian an	斜側削妙炒四法：前鏟
ong ao ：	五龍道：
u ong ao ：	五龍道：
： ie	掌藏龍：卸
ong ： ie	掌藏龍：卸
ang ong ： ie	掌藏龍：卸
an ong ie	蟠龍洩
ao ong o	蛟龍錯
ong a	真龍殺 龍甲 龍甲
en ong a	真龍殺
ei u en	五內如焚 逆陽神鑑：五內如焚
u ei u en	五內如焚 逆陽神鑑：五內如焚
ang an ang	光芒萬丈 地霸氣訣之陰陽玄剛
ang ang an ang	光芒萬丈
ao u ian i	焦土千里
ai en ian	煮海焚天
u ai en ian	煮海焚天
o ang ang	星火相撞
ing o ang ang	星火相撞
an ong ang	陽斷穹蒼
ang an ong ang	陽斷穹蒼
vn in ian a	至尊功：開山劈石：上天下地：排山倒海：千軍萬馬：君臨天下
ong ：	密宗黑教武功： 烈陽神功： 獅王神功： 閻王令邪功： 龍象般若功：
u ong ：	密宗黑教武功：
ao u ong ：	密宗黑教武功：
in ang in ong	密宗龍爪手：金剛擒龍
ang ang ：	密宗金剛掌：
in ang ang ：	密宗金剛掌：
ang an ong	密宗金剛腿：金剛盤龍
in ang an ong	密宗金剛腿：金剛盤龍
vn ie	掃蕩群邪
ang vn ie	掃蕩群邪
ao ang vn ie	掃蕩群邪
ei ing i	連環魁星踢
an ei ing i	連環魁星踢
ang o u	金剛魔伏
in ang o u	金剛魔伏
ong in ang an	密宗金剛拳
an ei an	烈旋水轉 魔典真經：人關紫藍內丹
ie an ei an	烈旋水轉
ian ou u ang	千手無量
II in ei	破日金錐
o II in ei	破日金錐
u ing ong ve	五行轟岳
ai ian o	盤古擊：開天破
： ai ian o	盤古擊：開天破
i i ei	闢地碎
ing ve	流星訣 流星訣 驚靈絕
ing ing ve	驚靈絕
ian i an	天地斬
II o	元始搏
an II o	元始搏
ie ing ：	貝葉經：
ei ie ing ：	貝葉經：
a u II	貝葉掌：法華渡世
a a u II	貝葉掌：法華渡世
u I ai	大千世界佛自在
ie u I ai	大千世界佛自在
a ei ong	萬法歸宗
an a ei ong	萬法歸宗
ang u u	貝葉刀：慈航普渡
I ang u u	貝葉刀：慈航普渡
eng i e	早登極樂
ao eng i e	早登極樂
ao ang o	伏妖降魔
u ao ang o	伏妖降魔
ai u II	力在布施
i ai u II	力在布施
ong e u ang	功德無量
i en ian	火尊訣：太極真焰
ai i en ian	火尊訣：太極真焰
ong ang ao ian	洪荒浩焰
an u e	水雲訣：泥船渡河
i an u e	水雲訣：泥船渡河
in o ang	金鱗破浪
in in o ang	金鱗破浪
in ang o	陰陽道：陰陽錯
： in ang o	陰陽道：陰陽錯
ang en en	陰陽混沌
in ang en en	陰陽混沌
i vn an	兩極循環
ang i vn an	兩極循環
ian ie II	義和大日玄功：吼天戰拳，吼天滅世
ou ian ie II	義和大日玄功：吼天戰拳，吼天滅世
ang ao ang	神鳥四絕：鳳凰朝王
eng ang ao ang	神鳥四絕：鳳凰朝王
： ai vn	渾天寶鑑：白雲
ian ： ai vn	渾天寶鑑：白雲
： ing i	雪冰：冰劈
ing ： ing i	雪冰：冰劈
： ing e	崩雪斬碧星河：星河
e ： ing e	崩雪斬碧星河：星河
e i an	星河氣旋
ing e i an	星河氣旋
e en II	斬星河困勢
ing e en II	斬星河困勢
en ： II	混沌：勢
en en ： II	混沌：勢
： en en	兩扇拱勢靛藍滄海：吞吞
ai ： en en	兩扇拱勢靛藍滄海：吞吞
ao ian II	滔天勢
ang an II	浪捲勢
en an II	深淵勢
ao ang ao ian	金晨曦：朝陽耀天
in ian an vn	金劍穿雲
ang an ve	雙芒趕月
ang ang an ve	雙芒趕月
ao in ong	五爪金龍
u ao in ong	五爪金龍
i an ian	霹靂戰天
i i an ian	霹靂戰天
i in an	無敵金環
u i in an	無敵金環
ang o v	金陽破獄
in ang o v	金陽破獄
II ang ei i	十陽歸一
ang o ing	金楊破嶺
in ang o ing	金楊破嶺
i an ve	十陽之氣穿越
II i an ve	十陽之氣穿越
ve eng ei	日月爭輝
II ve eng ei	日月爭輝
ong ang ：	血穹蒼：
ve ong ang ：	血穹蒼：
ang u a	穹蒼無涯
ong ang u a	穹蒼無涯
u i ong	血霧迷踪
ve u i ong	血霧迷踪
ang I ian	血陽撕天
ve ang I ian	血陽撕天
ong ang u ian	穹蒼無邊
ong ang u ei	穹蒼無悔
ong ang ve a	穹蒼血甲
ve ong ang	蒼穹血穹蒼
ong ve ong ang	蒼穹血穹蒼
ve eng	冰山雪崩 穹蒼血風
ang ve eng	穹蒼血風
ong ang ve eng	穹蒼血風
v ing ao	血雨晶刀
ve v ing ao	血雨晶刀
ei ong ang	血雨歸穹蒼
v ei ong ang	血雨歸穹蒼
ve ai u a	血海無涯
u ing ian	冰柱擎天
ing u ing ian	冰柱擎天
a ie	血雨腥風洗穹蒼玄宇宙：化劫
： a ie	血雨腥風洗穹蒼玄宇宙：化劫
ou ： a ie	血雨腥風洗穹蒼玄宇宙：化劫
a ao a	大爆炸
ian ing ian	天行健
ao II en	破虛空：撲前九式標誌真
II ao II en	破虛空：撲前九式標誌真
eng II ang	冰封十丈 冰封十丈
ing eng II ang	冰封十丈 冰封十丈
I u	冰寒刺骨 冰寒刺骨
an I u	冰寒刺骨 冰寒刺骨
ing an I u	冰寒刺骨 冰寒刺骨
a an an	冰剮萬斬 冰剮萬斬
ing a an an	冰剮萬斬 冰剮萬斬
e ang ang	冰河莽莽
ing e ang ang	冰河莽莽
an eng en	冰玄成盾 冰玄成盾
ing an eng en	冰玄成盾 冰玄成盾
ong ong II	冰玄凍空時
an ong ong II	冰玄凍空時
in ong II	狂麟凍噬
ang in ong II	狂麟凍噬
in ing	麒麟凝
i in ing	麒麟凝
an ve eng	冰山雪崩
ing an ve eng	冰山雪崩
ing e ang	冰河莽
II ong	空時空
ong II ong	空時空
ie o in	長生訣：長生烈火勁
eng ie o in	長生訣：長生烈火勁
an ing in	長生寒冰勁
eng an ing in	長生寒冰勁
o an in	兩極冰火螺旋勁：長生烈火螺旋勁 長生冰火螺旋勁：長生烈火螺旋勁 長生寒冰螺旋勁
o o an in	兩極冰火螺旋勁：長生烈火螺旋勁 長生冰火螺旋勁：長生烈火螺旋勁
ing o an in	長生寒冰螺旋勁
o o in	混渦渦旋勁：長生烈火渦勁
ie o o in	混渦渦旋勁：長生烈火渦勁
i i eng	和氏璧異能 和氏璧異能 和氏璧異能 和氏璧異能
II i i eng	和氏璧異能 和氏璧異能 和氏璧異能 和氏璧異能
ing o in	長生寒冰渦勁
an ing o in	長生寒冰渦勁
ing o	長生寒異冰渦
i ing o	長生寒異冰渦
an i ing o	長生寒異冰渦
II i eng	和氏璧能
e II i eng	和氏璧能
ve en i	三元氣功：長生訣真氣
eng ve en i	三元氣功：長生訣真氣
i e i	兩極歸元天地合一 聖帝舍利
eng i e i	聖帝舍利
en in en i	長生訣：先天純陰真氣
ang en i	先天純陽真氣
en ang en i	先天純陽真氣
eng u ie	長生不滅
ang eng u ie	長生不滅
i ian o	紫氣天羅
I i ian o	紫氣天羅
o ing an i	火星戰氣
ei ing an i	水星戰氣
in ing an i	金星戰氣
ing u e	上地至尊功：天罡氣訣之五行互克
u ing u e	上地至尊功：天罡氣訣之五行互克
ian an an u	不間斷亂舞
in ang an ang	地霸氣訣之陰陽玄剛
in i	至尊功之純陰氣 金級 金級
en in i	至尊功之純陰氣
II en in i	至尊功之純陰氣
ang ang i	烈陽剛氣
ie ang ang i	烈陽剛氣
ang ai	天蠶功：無尚天狀態 藍蒼海
ian ang ai	天蠶功：無尚天狀態
ang ian ang ai	天蠶功：無尚天狀態
： ang I	黑絕魔經：忘死
ing ： ang I	黑絕魔經：忘死
i o ong	離火玄冰功：離火功
： i o ong	離火玄冰功：離火功
an ing ong	玄冰功
e ong ：	龍象般若功：
o e ong ：	龍象般若功：
： in o	三火歸元功：陰火
ong ： in o	三火歸元功：陰火
i o	異火
： ong ian	九幽逆經奇功：紅焰 火焰神功：紅焰
ong ： ong ian	九幽逆經奇功：紅焰 火焰神功：紅焰
ve i an	婆羅魔經：絕息關
： ve i an	婆羅魔經：絕息關
ian u an	煉骨關
an ang en ei	魔光七重天：魔光綻放春雷
ang ing e u	魔光驚蟄伏
ang a u	魔光陽大暑
ang ang a u	魔光陽大暑
ve u i	魔光月無極
ang ve u i	魔光月無極
II u i	魔光日無極
ang II u i	魔光日無極
ian ：	冰火七重天： 玄陰寶鑑： 銀月聖典：
ong ian ：	冰火七重天：
i ong ian ：	冰火七重天：
II an a ing	昊天罡氣：十全霸境
II en in	密宗神功：大日輪印
a II en in	密宗神功：大日輪印
II I in	獅子印
en ou in	大金剛輪手印
ang en ou in	大金剛輪手印
en ei in	五世回二脈印元：五世輪迴印 五世輪迴印
II en ei in	五世回二脈印元：五世輪迴印 五世輪迴印
an a ang i	七十二罡氣：一轉八罡氣
ou ang i	七轉五十六罡氣 九陽一 二轉十六罡氣
II ou ang i	七轉五十六罡氣 二轉十六罡氣
I ang i	三轉二十四罡氣 八轉六十四罡氣
II I ang i	三轉二十四罡氣 八轉六十四罡氣
er ang i	九轉七十二罡氣 四轉三十二罡氣
II er ang i	九轉七十二罡氣 四轉三十二罡氣
II ang i	五轉四十罡氣
I II ang i	五轉四十罡氣
II a ang i	六轉四十八罡氣
in ve	童子功：童心訣 童子金身：童心訣
ong in ve	童子功：童心訣 童子金身：童心訣
： ong in ve	童子功：童心訣 童子金身：童心訣
vn ve	白雲訣 白雲訣
ai vn ve	白雲訣 白雲訣
ou ing ve	流星訣 流星訣
ing ve ve	明月訣 明月訣
ong II ve	紅日訣 紅日訣
I in en	童子金身
ong I in en	童子金身
： ao u	聖火神功：焦土
ong ： ao u	聖火神功：焦土
en ong ：	烈陽神功： 獅王神功：
ang en ong ：	烈陽神功： 獅王神功：
i ie i	閃電奇功：蓄電護體階梯
u i ie i	閃電奇功：蓄電護體階梯
en ie i	發電傷人階梯
ang en ie i	發電傷人階梯
： ie ing	凶獸魔功：滅性
ong ： ie ing	凶獸魔功：滅性
u ing vn	長恨歌：紫氣入青雲
i u ing vn	長恨歌：紫氣入青雲
u u ing	仙氣風峰處處處處行
u u u ing	仙氣風峰處處處處行
ve an ao eng	九闕三焦生
ong in in	千乘萬宮高浪重湧臨臨
ong ong in in	千乘萬宮高浪重湧臨臨
ing ei II	一念以貫之功：——以念聚意，悉意之所釋，一以氣神以貫之，以氣神以貫之，不能。一念以沛之，一剎神之貫之以十里，驚驚雷之
ing ing ei II	一念以貫之功：——以念聚意，悉意之所釋，一以氣神以貫之，以氣神以貫之，不能。一念以沛之，一剎神之貫之以十里，驚驚雷之
ie ong ：	閻王令邪功：
ing ie ong ：	閻王令邪功：
ong ： II	鬼打邪功：魑
ie ong ： II	鬼打邪功：魑
i ang ei ang	地藏鬼王
： u eng	大夢神功：入夢
ong ： u eng	大夢神功：入夢
i eng en	霹靂玄功：霹靂猛震
i i eng en	霹靂玄功：霹靂猛震
i ang ian	霹靂狂電
i i ang ian	霹靂狂電
i ao ei	霹靂暴雷
i i ao ei	霹靂暴雷
： an ai ian	金甲神功：山海篇
an ang ian	元陽篇
v ：	雷霆戰軀：
an v ：	雷霆戰軀：
ing an v ：	雷霆戰軀：
i a ian	天煞地氣功：地煞篇
： i a ian	天煞地氣功：地煞篇
ian a ian	天煞篇
ian i e i	兩極歸元天地合一
v u i	般若神功：綠菩提
： v u i	般若神功：綠菩提
an i en ong	烈火劫：火海無涯暴火劫：火輪煉獄天火劫：萬里焚空
en o ie	鬼火劫神火劫
ie en o ie	鬼火劫神火劫
ai o en ian	炎陽奇功：太火焚天
ie ong in	煮鐵融金
u ie ong in	煮鐵融金
an ao ang	火傘高張
o an ao ang	火傘高張
ang ao ao	驕陽耀耀
ao ang ao ao	驕陽耀耀
eng ian ：	銀月聖典：
ve eng ian ：	銀月聖典：
an o v	九死邪功：刀山火獄
ao an o v	九死邪功：刀山火獄
ian v	火海煉獄
ai ian v	火海煉獄
o ai ian v	火海煉獄
ing v en	寒冰獄魂
an ing v en	寒冰獄魂
i v	魔幻鼻獄
an i v	魔幻鼻獄
o an i v	魔幻鼻獄
ei ao v	陰雷暴獄
in ei ao v	陰雷暴獄
ei v	化骨魅獄
u ei v	化骨魅獄
a u ei v	化骨魅獄
i o v	離魔獄
a ve v	阿絕獄
ai e ao	九死邪功：奈何道 九死邪功：奈何道
： ai e ao	九死邪功：奈何道 九死邪功：奈何道
ei eng ao	回生道 回生道
ing eng ao	冥生道 冥生道
an u ao	梵爐道 梵爐道
an ang ao	斷梁道 斷梁道
a i ao	阿鼻道 阿鼻道
u ian ao	無間道
an eng ao	無間轉生道
ian an eng ao	無間轉生道
a a ：	九玄大法： 天地大法：
an a a ：	九玄大法：
ou ang i ai	九陽神功：第一陽心坎穴第二陽丹田穴第三陽足陽明胃穴第三陽足太陽經穴第五陽手小太陽經穴第六陽手少陽三焦經穴第七陽脊梁穴第八陽至陽穴第九陽百會穴：九陽啟泰
ou ang u ao	九陽普照
in ei an	九陰真經：九陰歸元
ou in ei an	九陰真經：九陰歸元
： ei u in	九陰寒屍功：碎骨勁
in i ve	九陰遺訣
ou in i ve	九陰遺訣
i a ang	九霄真經：霓霞象
： i a ang	九霄真經：霓霞象
u ian ang	霧電象
ao II ang	雪寶石像
ve ao II ang	雪寶石像
： i a	九霄真經：霓霞
ing ： i a	九霄真經：霓霞
o ei ing	霍雷霆
ve ang i i	雪糖霹靂
a ong	霸靇
： ao eng	九霄真經：颷風
ing ： ao eng	九霄真經：颷風
ou ei ang	九死輪迴大法：餓獸鬼王
e ou ei ang	九死輪迴大法：餓獸鬼王
i ei ang	瘟疫鬼王
en i ei ang	瘟疫鬼王
in ang ei ang	陰陽鬼王
ian ang ei ang	電光鬼王
ong ei ang	百蟲鬼王
ai ong ei ang	百蟲鬼王
ian ei ang	千眼鬼王
ian ian ei ang	千眼鬼王
o ei ang	森羅鬼王
en o ei ang	森羅鬼王
ie ei ang	無界鬼王
u ie ei ang	無界鬼王
e II en	萬惡世尊
an e II en	萬惡世尊
ei ：	九劫輪迴：
en ei ：	九劫輪迴：
ie en ei ：	九劫輪迴：
in ing ：	易筋經：
i in ing ：	易筋經：
i u ong	紅級浮工 黃級浮工
ong i u ong	紅級浮工
ang i u ong	黃級浮工
u ei i	級浮黑級
i u ei i	級浮黑級
： u ie	工況：初階
ang ： u ie	工況：初階
i u u	易筋經七級浮屠：紅級浮屠 白級浮屠 紫級浮屠 藍級浮屠 青級浮屠 黃級浮屠 黑級浮屠
ong i u u	易筋經七級浮屠：紅級浮屠
ang i u u	黃級浮屠
ing i u u	青級浮屠
an i u u	藍級浮屠
ai i u u	白級浮屠
I i u u	紫級浮屠
ei i u u	黑級浮屠
in ong ao	金鐘罩
ie u	鐵布衫：銅皮鐵骨
i ie u	鐵布衫：銅皮鐵骨
ong i ie u	鐵布衫：銅皮鐵骨
ai an a	鐵鎧戰甲
ie ai an a	鐵鎧戰甲
ie u an	鐵布衫
ong ai a	將軍令：銅鎧甲
： ong ai a	將軍令：銅鎧甲
in an ao	銀戰袍
in v i	金縷衣
： ing an	混元無極道：精關
ao ： ing an	混元無極道：精關
： ou ang	赤蓋四陽功：首陽
ong ： ou ang	赤蓋四陽功：首陽
o ing ang ong	火精當空
in o u ao	金鑼普照
an en ian	曦萬輪千
i an en ian	曦萬輪千
ai en eng	赤蓋焚城
II ai en eng	赤蓋焚城
： ian ang	幻魔四變：變相
ian ： ian ang	幻魔四變：變相
o eng ao an	鳳皇神罡：火鳳燎原
i ian ang	火翼天翔
o i ian ang	火翼天翔
II ei ang	振翅飛揚
en II ei ang	振翅飛揚
eng ie	火鳳涅
o eng ie	火鳳涅
eng ing ao ang	鳳鳴朝陽
o eng an u	火鳳亂舞
ou ong ian	再生鳳吼沖天
eng ou ong ian	再生鳳吼沖天
eng ang II	不滅鳳凰勢
ie eng ang II	不滅鳳凰勢
eng ang an	不滅鳳凰斷
ie eng ang an	不滅鳳凰斷
： en an	兩極心法：人關
a ： en an	兩極心法：人關
an ang ai	藍蒼海
in ong ang	金穹蒼
v ou	紫宇宙
I v ou	紫宇宙
ian ve ：	軒轅驚天訣：
ing ian ve ：	軒轅驚天訣：
en ：	盤古天殛震：
i en ：	盤古天殛震：
ian i en ：	盤古天殛震：
ian u ：	伏羲問天錄：
en ian u ：	伏羲問天錄：
eng ang in	軒轅三罡神功：風罡勁
： eng ang in	軒轅三罡神功：風罡勁
ei ang in	雷罡勁
ei an in	歸元勁
ong II i	降龍伏虎之氣：降龍之氣
ang ong II i	降龍伏虎之氣：降龍之氣
u II i	虎伏之氣
u u II i	虎伏之氣
ong u in	霹靂龍虎勁
i ong u in	霹靂龍虎勁
ian ing ：	如意天經：
i ian ing ：	如意天經：
i i ai	地極氣海 氣海無涯：天極氣海
ian i i ai	氣海無涯：天極氣海
i i i ai	地極氣海
o ian en	大日紫氣：電鎖乾坤
ian o ian en	大日紫氣：電鎖乾坤
i ong ai	紫氣東來
I i ong ai	紫氣東來
I a in	紫煞勁
ai ong ang	氣蓋穹蒼
i ai ong ang	氣蓋穹蒼
I i ei an	紫氣歸元
ian ing ei	雷電合擊：電驚雷
： ian ing ei	雷電合擊：電驚雷
ei i en	酩酊心法七重：醉一分——大醉七分
a ei i en	酩酊心法七重：醉一分——大醉七分
： o ou	天魔秘大法：：魔眸
a ： o ou	天魔秘大法：：魔眸
： o en	魔音：魔刃
in ： o en	魔音：魔刃
o en en	魔帶：天魔分身
ian o en en	魔帶：天魔分身
ao ian o	天魔舞：小天魔
： ao ian o	天魔舞：小天魔
II v en	玉石俱焚
v II v en	玉石俱焚
an in ：	截拳勁：
ie an in ：	截拳勁：
i i ing	冰心訣：心若冰清，天墜不驚，萬變猶定，神怡氣靜
en i i ing	冰心訣：心若冰清，天墜不驚，萬變猶定，神怡氣靜
I ao ao	宓，虛無物無相生，陀相成份與物忘，同混涅天無天涯，萬物齊乎花落葉，虛若若般，千愁憂，才下心頭即展眉頭，靈臺清幽心掛無憂，谷意無所執執心幽釋神，莫無魂千般憂，才下心頭即展眉頭，靈臺清，水流心不驚，雲贅在意具遲一心不物，古今自逍遙
in I ao ao	宓，虛無物無相生，陀相成份與物忘，同混涅天無天涯，萬物齊乎花落葉，虛若若般，千愁憂，才下心頭即展眉頭，靈臺清幽心掛無憂，谷意無所執執心幽釋神，莫無魂千般憂，才下心頭即展眉頭，靈臺清，水流心不驚，雲贅在意具遲一心不物，古今自逍遙
eng eng ve	正一純陽功：旭陽級：乘風訣
： eng eng ve	正一純陽功：旭陽級：乘風訣
ai i eng	太極封
ian an u	兩儀劍烈陽級：天蠶縛
： ian an u	兩儀劍烈陽級：天蠶縛
an ing ie	玄冰結
： ian en en	泰山崩純陽級：乾坤身
en ang ang	純陽掌
I ing ian	四靈劍
i ing ：	陰世奇經：
II i ing ：	陰世奇經：
in II i ing	日月神鑑：陰世奇經
ang II i ing	陽世奇經
ie ang en ong	日月神鑑：烈陽神功
ve eng ian	銀月聖典
in ve eng ian	銀月聖典
i a a ：	天地大法：
ian i a a	天地大法
ang a ：	大陽法：
a ang a ：	大陽法：
a ang a	一倍大陽法
ei a ang a	一倍大陽法
ian a ：	天法：
ei a in	三倍大陰
an ei a in	三倍大陰
I ei	四倍
o in ：	奇門閻羅勁：
ian o in ：	奇門閻羅勁：
： u i	達摩功：土級 達摩金身：土級
ong ： u i	達摩功：土級
en ： u i	達摩金身：土級
an ie i	霸王神功：無環裂地
u an ie i	霸王神功：無環裂地
u I ian	無柱撕天
u u I ian	無柱撕天
en u o	無恨無我
u en u o	無恨無我
II er	神脈訣：經脈十二
ai II er	神脈訣：經脈十二
ing ai II er	神脈訣：經脈十二
ai II u	絡脈十五
o ai II u	絡脈十五
ao ian ：	玄陰寶鑑：
in ao ian ：	玄陰寶鑑：
I an ei an	魔典真經：人關紫藍內丹
v ei an	地關碧綠內丹
i v ei an	地關碧綠內丹
ong ei an	天關赤紅內丹
II ong ei an	天關赤紅內丹
ian an en	梵我不二大法：小梵天禪震
an ian an en	梵我不二大法：小梵天禪震
an o u i	大梵天震慣配合心法：梵我如一
en e ei ong	井中月&遁去的一配合任何內功
i ai a	不壞金身：琉璃鎧甲 舍利鎧甲
ou i ai a	不壞金身：琉璃鎧甲
ei ai a	驚雷鎧甲
ing ei ai a	驚雷鎧甲
e i ai a	舍利鎧甲
ao u ang ong	無相功：小無相功
a u ang ong	大無相功
： ei a	甲骨功：龜甲 魔骷甲：龜甲
ong ： ei a	甲骨功：龜甲
an a a	金禪袈裟 金禪袈裟
in an a a	金禪袈裟 金禪袈裟
a ： ei a	魔骷甲：龜甲
o u a	骷髏魔骷甲
ou o u a	骷髏魔骷甲
i ： in	五行氣：金
ing i ： in	五行氣：金
： an in	逍遙令神功：鍛筋
ong ： an in	逍遙令神功：鍛筋
